pert_iname	classes
quinpirole	Dopamine receptor agonist
flavanone	11-beta-HSD1 inhibitor
rutin	Antioxidant|Capillary stabilizing agent|Nitric oxide scavenger
6-benzylaminopurine	Purinergic receptor activator
tyrphostin-AG-527	Protein tyrosine kinase inhibitor
tyrphostin-AG-82	EGFR inhibitor
AG-957	Protein tyrosine kinase inhibitor
AG-99	Tyrosine kinase inhibitor
alaproclate	Serotonin receptor antagonist
albendazole	Tubulin inhibitor
alclometasone	Glucocorticoid receptor agonist
alfuzosin	Adrenergic receptor antagonist
aliskiren	Antihypertensive agent|Renin inhibitor|Peptidase inhibitor|Protease inhibitor
alprenolol	Adrenergic receptor antagonist
alrestatin	Aldose reductase inhibitor
altizide	Thiazide diuretic
altrenogest	Progestogen hormone
altretamine	DNA synthesis inhibitor
ALX-5407	Glycine transporter inhibitor
AM-281	Cannabinoid receptor antagonist
ambelline	Plant alkaloid
amcinonide	Glucocorticoid receptor agonist
AMG-9810	TRPV antagonist
spiramide	Dopamine receptor antagonist|Serotonin receptor antagonist
aminoglutethimide	Glucocorticoid receptor antagonist
aminopentamide	Acetylcholine receptor antagonist
amiodarone	Potassium channel blocker
amlodipine	Calcium channel blocker
amoxapine	Norepinephrine reputake inhibitor
amsacrine	Topoisomerase inhibitor
anagrelide	Phosphodiesterase inhibitor
phenazone	Cyclooxygenase inhibitor
apigenin	Casein kinase inhibitor|Cell proliferation inhibitor|Cytochrome P450 inhibitor
ARC-239	Adrenergic receptor antagonist
asiatic-acid	Apoptosis stimulant
ATPA	Glutamate receptor agonist
azaperone	Dopamine receptor antagonist
Ala-Ala-Phe-CMK	Tripeptidyl peptidase inhibitor
alfaxalone	Chloride channel agonist|GABA receptor agonist
ambroxol	Sodium channel blocker
CS-1657	PARP inhibitor
amisulpride	Dopamine receptor antagonist
amodiaquine	Histamine receptor agonist
amperozide	Dopamine receptor antagonist
amyleine	Local anesthetic
anpirtoline	Serotonin receptor agonist
arcyriaflavin-a	CDK inhibitor
articaine	Local anesthetic
asiaticoside	Anticancer agent
atovaquone	Mitochondrial electron transport inhibitor
FTase-inhibitor-B581	Farnesyltransferase inhibitor
BADGE	PPAR receptor antagonist
bendroflumethiazide	Sodium/potassium/chloride transporter inhibitor
benzoxiquine	Antiinfective drug
benzthiazide	Carbonic anhydrase inhibitor
bepridil	Calcium channel blocker
betamethasone	Glucocorticoid receptor agonist
betamethasone-acetate	Glucocorticoid receptor agonist
BH3I-1	BCL inhibitor
BIBU-1361	EGFR inhibitor
BIBX-1382	EGFR inhibitor|Tyrosine kinase inhibitor
biperiden	Acetylcholine receptor antagonist
bisacodyl	Laxative
bisoprolol	Adrenergic receptor antagonist
bithionol	Autotaxin inhibitor
BMS-182874	Endothelin receptor antagonist
BMY-45778	IP1 prostacyclin receptor agonist
BNTX	Opioid receptor antagonist
brazilin	Nitric oxide production inhibitor
BRL-52537	Opioid receptor agonist
bromhexine	Mucolytic agent
bromocriptine	Dopamine receptor agonist
brompheniramine	Histamine receptor antagonist
brucine	Glycine receptor antagonist
BU-224	Imidazoline receptor ligand|Imidazoline ligand
BU-226	Imidazoline receptor ligand|Imidazoline ligand
budesonide	Glucocorticoid receptor agonist
bupropion	Dopamine uptake inhibitor
buspirone	Serotonin receptor agonist
butyl-paraben	DNA synthesis inhibitor
BVT-948	Tyrosine phosphatase inhibitor
BW-B70C	Lipoxygenase inhibitor
byssochlamic-acid	Mycotoxin
benazepril	Angiotensin converting enzyme inhibitor
benzamil	Sodium channel blocker
benzonatate	Local anesthetic
benzopurpurin-4b	Binds HIV gp120 and inhibits HIV-1 entry into the neural cell line SK-N-MC
bergenin	Interleukin inhibitor
bisindolylmaleimide	CDK inhibitor|PKC inhibitor
bucladesine	Adenosine receptor agonist|CAMP stimulant
ceramide	Phosphoenolpyruvate carboxylase activator|Serine/threonine protein phosphatase activator
CA-074-Me	Cathepsin inhibitor
caffeine	Adenosine receptor antagonist|Phosphodiesterase inhibitor
candesartan-cilextil	Angiotensin receptor antagonist
canrenoic-acid	Mineralocorticoid receptor antagonist
carbamazepine	Carboxamide antiepileptic
carbinoxamine	Histamine receptor antagonist|L-type calcium channel blocker
carvedilol	Adrenergic receptor antagonist
celecoxib	Cyclooxygenase inhibitor
CGP-54626	GABA receptor antagonist
CGP-57380	MAPK-interacting kinase inhibitor|MAP kinase inhibitor
CGS-15943	Adenosine receptor antagonist
chlorambucil	DNA inhibitor
chlormadinone-acetate	5 alpha reductase inhibitor
chloroquine	Antimalarial agent
chloroxine	Opioid receptor antagonist
chlorphenamine	Histamine receptor antagonist
chlorpromazine	Dopamine receptor antagonist
chlorprothixene	Dopamine receptor antagonist
chlorthalidone	Carbonic anhydrase inhibitor
cilostazol	Phosphodiesterase inhibitor
cimetidine	Histamine receptor antagonist
cinanserin	Serotonin receptor antagonist
cinchonine	P-glycoprotein inhibitor
CITCO	CAR agonist
clemastine	Histamine receptor antagonist
clobetasol	Glucocorticoid receptor agonist
clofibrate	PPAR receptor agonist
clomifene	Estrogen receptor antagonist
clonidine	Adrenergic receptor agonist
CMPD-1	P38 MAPK inhibitor
CNQX	Glutamate receptor antagonist
colforsin	Adenylyl cyclase activator
cortisone-acetate	Glucocorticoid receptor agonist
coumarin	Vitamin K antagonist
CV-1808	Adenosine receptor agonist
cyanopindolol	Adrenergic receptor antagonist
cycloheximide	Protein synthesis inhibitor
cyclopentolate	Acetylcholine receptor antagonist
cyclopiazonic-acid	ATPase inhibitor
cyclosporin-a	Calcineurin inhibitor
calcipotriol	Vitamin D receptor agonist
SA-792709	Retinoid receptor agonist
chelidonine	Tubulin inhibitor
chlorphenesin-carbamate	Muscle relaxant
chlortetracycline	Protein synthesis inhibitor
chromanol	Potassium channel blocker
cimaterol	Adrenergic receptor agonist
cisapride	Serotonin receptor agonist
citalopram	Serotonin reuptake inhibitor
clebopride	Dopamine receptor antagonist
clioquinol	Chelating agent
CO-101244	Ionotropic glutamate receptor antagonist
cortisone	Glucocorticoid receptor agonist
corynanthine	Adrenergic receptor antagonist
danazol	Estrogen receptor antagonist|Progesterone receptor agonist
daunorubicin	RNA synthesis inhibitor|Topoisomerase inhibitor
DCPIB	Chloride channel blocker|Gap junction modulator|Glutamate inhibitor
gedunin	HSP inhibitor
deracoxib	Cyclooxygenase inhibitor
desipramine	Tricyclic antidepressant
desoximetasone	Glucocorticoid receptor agonist
desoxypeganine	Acetylcholinesterase inhibitor|Monoamine oxidase inhibitor
dexamethasone	Glucocorticoid receptor agonist
dexamethasone-acetate	Glucocorticoid receptor agonist|Corticosteroid agonist|Cytochrome P450 inhibitor
dextromethorphan	Glutamate receptor antagonist|Sigma receptor agonist
dibenzoylmethane	Anticancer agent
diclofenac	Cyclooxygenase inhibitor
dicycloverine	Acetylcholine receptor antagonist
dienestrol	Estrogen receptor agonist
diethylcarbamazine	Lipoxygenase inhibitor
diethylstilbestrol	Estrogen receptor agonist
diflunisal	Prostanoid receptor antagonist
digitoxin	ATPase inhibitor
digoxin	ATPase inhibitor
dihomo-gamma-linolenic-acid	Cholesterol inhibitor|Platelet aggregation inhibitor|Prostanoid receptor stimulant|Prostanoid receptor agonist
dihydro-7-desacetyldeoxygedunin	HSP inhibitor
dihydrodeoxygedunin	Growth factor receptor activator
dihydroergocristine	Adrenergic receptor antagonist|Prolactin inhibitor
dihydroergotamine	Serotonin receptor agonist
dihydrosamidin	Nitric oxide production inhibitor|Phospholipase inhibitor|Platelet activating factor receptor antagonist
diloxanide	Protein synthesis inhibitor
diltiazem	Calcium channel blocker
dioxybenzone	Topical sunscreen agent
dipropyl-dopamine	Dopamine receptor agonist
dipyridamole	Phosphodiesterase inhibitor
disopyramide	Sodium channel blocker
DMBI	PDGFR tyrosine kinase receptor inhibitor|VEGFR inhibitor
DMSO	Control vehicle
domperidone	Dopamine receptor antagonist
donepezil	Acetylcholinesterase inhibitor
doxepin	Histamine receptor antagonist
doxorubicin	Topoisomerase inhibitor
doxylamine	Histamine receptor antagonist
DPO-1	Potassium channel blocker
droperidol	Dopamine receptor antagonist
duloxetine	Norepinephrine reuptake inhibitor|Serotonin reuptake inhibitor
daidzein	Estrogen receptor agonist
daphnetin	Protein kinase inhibitor
dephostatin	Tyrosine phosphatase inhibitor
digitoxigenin	ATPase inhibitor
dihydrexidine	Dopamine receptor agonist
dilazep	Adenosine reuptake inhibitor
diphemanil	Acetylcholine receptor antagonist
dipivefrine	Adrenergic receptor agonist
dorsomorphin	AMPK inhibitor
dubinidine	Antiepileptic
E-4031	Potassium channel blocker
berbamine	Calmodulin antagonist
icosapent	Platelet aggregation inhibitor
EMD-386088	Serotonin receptor agonist
emetine	Protein synthesis inhibitor
ephedrine	Adrenergic receptor agonist
epicatechin-gallate-(-)	Bacterial DNA gyrase inhibitor
epirubicin	Topoisomerase inhibitor
equilin	Estrogen receptor agonist
erythromycin-estolate	Bacterial 50S ribosomal subunit inhibitor
erythromycin-ethylsuccinate	Cytochrome P450 inhibitor|Motilin receptor agonist|NFkB pathway inhibitor|Protein synthesis inhibitor
erythrosine	Coloring agent
escitalopram	Selective serotonin reuptake inhibitor (SSRI)
estradiol	Estrogen receptor agonist
estradiol-benzoate	Contraceptive agent
estradiol-cypionate	Estrogen receptor agonist
estriol	Estrogen receptor agonist
estrone	Estrogen receptor agonist|Estrogenic hormone
estropipate	Estrogen receptor agonist
etacrynic-acid	Sodium/potassium/chloride transporter inhibitor
etamivan	Respiratory stimulant
ethinyl-estradiol	Estrogen receptor agonist|DNA directed DNA polymerase stimunlant|Estrogenic component in oral contraceptives
ethoprop	Acetylcholinesterase inhibitor
profenamine	Butyrylcholinesterase inhibitor|Cholinergic receptor antagonist
etodolac	Cyclooxygenase inhibitor
etomidate	GABA receptor modulator
eugenol	Androgen receptor antagonist
exemestane	Aromatase inhibitor
ezetimibe	Cholesterol inhibitor|Niemann-Pick C1-like 1 protein antagonist
vinburnine	Adrenergic receptor antagonist
eliprodil	Glutamate receptor antagonist
ergocryptine	Dopamine agonist
etazolate	Phosphodiesterase inhibitor
ethotoin	Hydantoin antiepileptic
eticlopride	Dopamine receptor antagonist
etilefrine	Adrenergic receptor agonist
etoposide	Topoisomerase inhibitor
famciclovir	DNA polymerase inhibitor
fenbufen	Cyclooxygenase inhibitor
fenoterol	Adrenergic receptor agonist
fexofenadine	Histamine receptor antagonist
FG-7142	GABA benzodiazepine site receptor inverse agonist
FGIN-1-27	Inositol monophosphatase inhibitor
FGIN-1-43	Benzodiazepine receptor agonist
fipronil	Chloride channel blocker|GABA gated chloride channel blocker
fludrocortisone-acetate	Glucocorticoid receptor agonist|Mineralocorticoid receptor agonist
flunarizine	Calcium channel blocker
fluocinolone	Glucocorticoid receptor agonist
fluocinolone-acetonide	Corticosteroid agonist|Glucocorticoid receptor agonist
fluorometholone	Glucocorticoid receptor agonist
flutamide	Androgen receptor antagonist
fluvastatin	HMGCR inhibitor
fraxetin	Antioxidant
flecainide	Sodium channel blocker
fluoxetine	Selective serotonin reuptake inhibitor (SSRI)
fluspirilene	Dopamine receptor antagonist
forskolin	Adenylyl cyclase activator
fursultiamine	Vitamin B
gemfibrozil	Lipoprotein lipase activator
gingerol	Nitric oxide synthase inhibitor
gitoxigenin	ATPase inhibitor
ilomastat	Matrix metalloprotease inhibitor
5'-guanidinonaltrindole	Opioid receptor antagonist
GR-103691	Dopamine receptor antagonist
GR-113808	Serotonin receptor antagonist
GR-135531	Melatonin receptor agonist
GSK-3-inhibitor-II	PKC inhibitor
guaifenesin	Expectorant
guanabenz	Adrenergic receptor agonist
guanfacine	Adrenergic receptor agonist
GW-1929	PPAR receptor agonist|Insulin sensitizer
GW-3965	LXR agonist|ABC transporter expression enhancer
GW-4064	FXR agonist
GW-5074	RAF inhibitor|Leucine rich repeat kinase inhibitor
GW-7647	PPAR receptor agonist
galantamine	Acetylcholinesterase inhibitor
gelsemine	Acetylcholine receptor antagonist|Glycine receptor antagonist
glycocholic-acid	Cholesterol inhibitor
glycodeoxycholic-acid	Apoptosis stimulant
guanaben-acetate	Adrenergic receptor agonist
hydroxyfasudil	Rho associated kinase inhibitor
haloperidol	Dopamine receptor antagonist
hexylresorcinol	Local anesthetic
homatropine	Acetylcholine receptor antagonist
HTMT	Histamine receptor agonist
hydrocortisone-acetate	Corticosteroid agonist|Glucocorticoid receptor agonist
hydrocortisone-hemisuccinate	Glucocorticoid receptor agonist
hydrocortisone-phosphate	Glucocorticoid receptor agonist
hyoscyamine	Acetylcholine receptor antagonist
hypericin	Tyrosine kinase inhibitor
heliotrine	Pyrrolizidine alkaloid
helveticoside	ATPase inhibitor
homochlorcyclizine	Antihistamine
huperzine-a	Acetylcholinesterase inhibitor|Glutamate receptor antagonist
hydrocotarnine	Opioid receptor antagonist
hydroquinine	Antiarrhythmic
hydroxytacrine-maleate-(r,s)	Cholinesterase inhibitor
hymecromone	Monoamine oxidase inhibitor
I-OMe-AG-538	Inhibitor of insulin growth factor 1 receptor protein tyrosine kinase
IB-MECA	Adenosine receptor agonist
ibuprofen	Cyclooxygenase inhibitor
icariin	Phosphodiesterase inhibitor
ICI-204448	Opioid receptor agonist
ICI-63197	Phosphodiesterase inhibitor
ICI-118551	Adrenergic receptor antagonist
imipramine	Norepinephrine reputake inhibitor|Serotonin reuptake inhibitor
INCA-6	Calcineurin inhibitor
indapamide	Thiazide diuretic
indirubin	CDK inhibitor|Glycogen synthase kinase inhibitor
indometacin	Cyclooxygenase inhibitor
indoprofen	Cyclooxygenase inhibitor|Prostanoid receptor antagonist
iopanoic-acid	Radiopaque medium
irbesartan	Angiotensin receptor antagonist
iso-olomoucine	CDK inhibitor
isogedunin	HSP inhibitor
isoxicam	Cyclooxygenase inhibitor
isoxsuprine	Adrenergic receptor agonist
icilin	TRPV agonist
imiloxan	Adrenergic receptor antagonist
immethridine	Histamine receptor agonist
indirubin-3-monoxime	CDK inhibitor|Glycogen synthase kinase inhibitor
iocetamic-acid	Radiopaque medium
ipratropium	Acetylcholine receptor antagonist
ipsapirone	Serotonin receptor agonist
isradipine	Calcium channel blocker
ketorolac	Cyclooxygenase inhibitor
ketotifen	Histamine receptor agonist|Leukotriene receptor antagonist|Phosphodiesterase inhibitor|Histamine receptor ligand
karakoline	Phytotoxin
kawain	Calcium channel modulator|MTOR inhibitor|Sodium channel blocker
KI-8751	VEGFR inhibitor|KIT inhibitor|PDGFR tyrosine kinase receptor inhibitor
L-161982	Prostanoid receptor antagonist
L-670596	Prostanoid receptor antagonist
L-755507	Adrenergic receptor agonist
L-168049	Glucagon receptor antagonist
L-655708	GABA receptor inverse agonist
L-701324	Glutamate receptor antagonist
L-741742	Dopamine receptor antagonist
L-stepholidine	Dopamine receptor agonist|Dopamine receptor antagonist
labetalol	Adrenergic receptor antagonist
lasalocid	Bacterial permeability inducer
leu-enkephalin	Opioid receptor agonist
linoleic-acid	Oxidative stress inducer
liothyronine	Thyroid hormone stimulant
liquiritigenin	Aromatase inhibitor
lobaric-acid	Tyrosine phosphatase inhibitor
lobendazole	Anthelmintic agent
loxapine	Dopamine receptor antagonist|Serotonin receptor antagonist
lupanine	Sodium channel blocker
LY-344864	Serotonin receptor agonist
tomelukast	Leukotriene receptor antagonist
LY-294002	MTOR inhibitor|DNA dependent protein kinase inhibitor|Phosphodiesterase inhibitor|PLK inhibitor
LY-83583	Guanylyl cyclase inhibitor
laudanosine	Central nervous system agent
letrozole	Aromatase inhibitor
leucodin	Melanin inhibitor
linopirdine	Potassium channel blocker
marmesin	Angiogenesis inhibitor
MBCQ	Phosphodiesterase inhibitor
MDL-11939	Serotonin receptor antagonist
MDL-29951	Glutamate receptor antagonist
MDL-73005EF	Serotonin receptor antagonist
mebeverine	Acetylcholine receptor antagonist
meloxicam	Cyclooxygenase inhibitor
menadione	Mitochondrial DNA polymerase inhibitor|Phosphatase inhibitor
mephentermine	Adrenergic receptor agonist
mesulergine	Dopamine receptor agonist
methoxsalen	DNA synthesis inhibitor
methylergometrine	Dopamine receptor antagonist|Serotonin receptor antagonist
methysergide	Serotonin receptor antagonist
metolazone	Carbonic anhydrase inhibitor
mexiletine	Sodium channel blocker
midodrine	Adrenergic receptor agonist
minaprine	Serotonin reuptake inhibitor
mitomycin-c	DNA alkylating drug|DNA inhibitor|DNA alkylating agent|DNA synthesis inhibitor
mitotane	Antineoplastic agent
MK-212	Serotonin receptor agonist
ML-9	Myosin light chain kinase inhibitor
MRS-1334	Adenosine receptor antagonist
maprotiline	Norepinephrine reputake inhibitor|Tricyclic antidepressant
medetomidine	Adrenergic receptor agonist
megestrol	Progesterone receptor agonist
mephenytoin	Hydantoin antiepileptic
metanephrine	Epinephrine metabolite
metergoline	Dopamine receptor agonist|Serotonin receptor antagonist
methyl-2,5-dihydroxycinnamate	Tyrosine kinase inhibitor|EGFR inhibitor
metixene	Acetylcholine receptor antagonist
metrizamide	Radiopaque medium
metyrapone	Cytochrome P450 inhibitor
mirtazapine	Adrenergic receptor antagonist|Serotonin receptor antagonist
molindone	Dopamine receptor antagonist
moracizine	Sodium channel blocker
mycophenolic-acid	Dehydrogenase inhibitor|Inositol monophosphatase inhibitor
BRD-K51557114	GlyT-2 inhibitor
BRD-K98297262	Fungal 1,3-beta-D-glucan synthase inhibitor
N-formylmethionylalanine	Macrophage activator
N-methylquipazine	Serotonin receptor agonist
N20C	Glutamate receptor antagonist
N6-cyclopentyladenosine	Adenosine receptor agonist
nabumetone	Cyclooxygenase inhibitor
nadolol	Adrenergic receptor antagonist
naftidrofuryl	Adrenergic receptor antagonist
naltrexone	Opioid receptor antagonist
naproxol	Anti-inflammatory agent
NBQX	Glutamate receptor antagonist
NCS-382	GABA receptor antagonist
nicardipine	Calcium channel blocker
nicergoline	Adrenergic receptor antagonist
niclosamide	DNA replication inhibitor|STAT inhibitor
nicotine	Acetylcholine receptor agonist
nimodipine	Calcium channel blocker
nitrendipine	Calcium channel blocker
nitrofural	Bacterial DNA inhibitor
nocodazole	Tubulin inhibitor
norethindrone	Progestogen hormone
norgestimate	Progesterone receptor agonist
NS-1619	Calcium channel activator
NS-3694	Glutamate receptor antagonist
NSC-119889	Protein synthesis inhibitor
NSC-23766	Ras GTPase inhibitor
NSC-663284	CDC inhibitor
NU-7026	DNA dependent protein kinase inhibitor|MTOR inhibitor|PI3K inhibitor
tosyl-phenylalanyl-chloromethyl-ketone	Chymotrypsin inhibitor
nalbuphine	Opioid receptor agonist|Opioid receptor antagonist
naloxone	Opioid receptor antagonist
naringenin	Aromatase inhibitor|TRPV antagonist
naringin	Cytochrome P450 inhibitor
niridazole	Phosphofructokinase inhibitor
olmesartan-medoxomil	Angiotensin receptor antagonist
ornidazole	Antiprotozoal agent
ouabain	ATPase inhibitor
oxantel	Anthelmintic agent
oxaprozin	Cyclooxygenase inhibitor
oxfendazole	Anthelmintic agent
oxibendazole	Tubulin inhibitor
oxotremorine-sesquifumarate	Cholinergic receptor agonist
oleylethanolamide	Cannabinoid receptor agonist|Glucose dependent insulinotropic receptor agonist|Potassium channel blocker
ondansetron	Serotonin receptor antagonist
oxprenolol	Adrenergic receptor antagonist
ozagrel	Thromboxane synthase inhibitor
PAC-1	Caspase activator
paclitaxel	Tubulin inhibitor
paroxetine	Selective serotonin reuptake inhibitor (SSRI)
PD-158780	EGFR inhibitor
penicillic-acid	Other antibiotic
benzylpenicillin	Penicillin binding protein inhibitor
penitrem-a	Potassium channel blocker
pentobarbital	Barbiturate antiepileptic|GABA receptor modulator
pergolide	Dopamine receptor agonist
perindopril	Angiotensin converting enzyme inhibitor
periplocymarin	Apoptosis stimulant
perphenazine	Dopamine receptor antagonist
PETCM	Caspase activator
PHCCC	Glutamate receptor agonist
phenacetin	Cyclooxygenase inhibitor
phenamil	TRPV antagonist
phenolphthalein	Indicator dye
phentermine	Dopamine uptake inhibitor|Serotonin reuptake inhibitor
physostigmine	Cholinesterase inhibitor|Acetylcholinesterase inhibitor
piceid	Glucosidase inhibitor
pindolol	Adrenergic receptor antagonist
pioglitazone	PPAR receptor agonist|Insulin sensitizer
pipamperone	Dopamine receptor antagonist
piperidolate	Acetylcholine receptor antagonist
piperine	Monoamine oxidase inhibitor
piperlongumine	Glutathione transferase inhibitor
pirenperone	Serotonin receptor antagonist
piroxicam	Cyclooxygenase inhibitor
pizotifen	Serotonin receptor antagonist
praziquantel	Anthelmintic agent
PRE-084	Sigma receptor agonist
prednisolone	Glucocorticoid receptor agonist
prednisolone-acetate	Glucocorticoid receptor agonist
prednisolone-hemisuccinate	Glucocorticoid receptor agonist
prednisone	Glucocorticoid receptor agonist
pregnenolone-succinate	GABA receptor negative allosteric modulator|Acetylcholine release enhancer|Dopamine release enhancer|Glutamate receptor modulator
primaquine	Antimalarial agent|DNA inhibitor
primidone	GABA receptor antagonist
proadifen	Nitric oxide synthase inhibitor
prochlorperazine	Dopamine receptor antagonist
progesterone	Progesterone receptor agonist
promazine	Dopamine receptor antagonist
propentofylline	Adenosine reuptake inhibitor|Phosphodiesterase inhibitor
protriptyline	Tricyclic antidepressant
PSB-06126	NTPDase inhibitor
PSB-069	NTPDase inhibitor
PSB-1115	Adenosine receptor antagonist
PSB-36	Adenosine receptor antagonist
paxilline	Potassium channel blocker
pepstatin	Aspartic protease inhibitor
phensuximide	Succinimide antiepileptic
pifithrin-mu	HSP inhibitor
piribedil	Dopamine receptor agonist
pirlindole	Monoamine oxidase inhibitor
pivmecillinam	Bacterial cell wall synthesis inhibitor
practolol	Adrenergic receptor antagonist
prednicarbate	Phospholipase activator
proscillaridin	ATPase inhibitor
protein-tyrosine-phosphatase-inhibitor-IV	Tyrosine phosphatase inhibitor
protopine	Histamine receptor antagonist
purvalanol-a	CDK inhibitor|DYRK inhibitor
purvalanol-b	Tyrosine kinase inhibitor
quetiapine	Dopamine receptor antagonist|Serotonin receptor antagonist
mepacrine	NFkB pathway inhibitor|Cytokine production inhibitor|TP53 activator
quinapril	Angiotensin converting enzyme inhibitor
quipazine	Serotonin receptor agonist
QX-222	Sodium channel blocker
quinethazone	Thiazide diuretic
R-59022	Diacylglycerol kinase inhibitor|Protein kinase inhibitor
BRD-K16604360	Antiamyloidogenic agent
r(-)-propylnorapomorphine	Dopamine receptor agonist
ephedrine-(racemic)	Adrenergic receptor agonist
raloxifene	Estrogen receptor antagonist|Selective estrogen receptor modulator (SERM)
resorcinol	Phosphodiesterase inhibitor
rhamnetin	Aldose reductase inhibitor
rhapontin	Apoptosis stimulant
rhodomyrtoxin	Cytotoxic agent|DNA intercalator
rhodomyrtoxin-b	Cytotoxic agent|DNA intercalator
ritanserin	Serotonin receptor antagonist
rizatriptan	Serotonin receptor agonist
RK-682	Tyrosine phosphatase inhibitor
benzyl-quinazolin-4-yl-amine	EGFR inhibitor
Ro-04-6790	Serotonin receptor antagonist
robustic-acid	CAMP inhibitor
rofecoxib	Cyclooxygenase inhibitor
rolipram	Phosphodiesterase inhibitor
ropinirole	Dopamine receptor agonist
rosuvastatin	HMGCR inhibitor
RS-102895	CCR antagonist
RS-39604	Serotonin receptor antagonist
RS-79948	Adrenergic receptor antagonist
RU-24969	Serotonin receptor agonist
RU-28318	Cytochrome P450 inhibitor
RX-821002	Adrenergic receptor antagonist
ramipril	Angiotensin converting enzyme inhibitor
ranitidine	Histamine receptor antagonist
repaglinide	Insulin secretagogue
mepireserpate	Catecholamine depleting sympatholytic
resmethrin	Cytochrome P450 inhibitor
retrorsine	Antimitotic agent|Cytotoxic agent|Mutagenic
RHO-kinase-inhibitor-II	Rho associated kinase inhibitor
riboflavin	Vitamin B2
ricinine	Casein kinase inhibitor
ritodrine	Adrenergic receptor agonist
Ro-25-6981	Ionotropic glutamate receptor antagonist|Monamine transporter modulator
bisindolylmaleimide-ix	PKC inhibitor
Ro-90-7501	Beta amyloid inhibitor
rottlerin	MAP kinase inhibitor|Protein kinase inhibitor
S-14506	Serotonin receptor agonist
salicin	Anti-inflammatory agent
sappanone-a	Melanin inhibitor|Tyrosinase inhibitor
SB-203186	Serotonin receptor antagonist
SB-206553	Serotonin receptor antagonist
SB-216641	Serotonin receptor antagonist
SB-218078	CHK inhibitor
SB-258585	Serotonin receptor antagonist
SC-19220	Prostanoid receptor antagonist
SCH-28080	ATPase inhibitor
scopoline	Acetylcholine receptor antagonist
SD-169	P38 MAPK inhibitor
SDM-25N	Opioid receptor antagonist
selamectin	Nematocide
sertraline	Serotonin receptor antagonist
SIB-1893	Glutamate receptor antagonist
sildenafil	Phosphodiesterase inhibitor
simvastatin	HMGCR inhibitor
SKF-83566	Dopamine receptor antagonist
SKF-96365	Calcium channel blocker
dehydrocholate	Choleretic agent
solifenacin	Acetylcholine receptor antagonist
spiperone	Dopamine receptor antagonist
SQ-29548	Thromboxane receptor antagonist
mifobate	PPAR receptor antagonist
gabazine	GABA receptor antagonist
ST-638	Tyrosine kinase inhibitor
strychnine	Acetylcholine receptor antagonist
sulfinpyrazone	Uricosuric blocker
salsolinol	Monoamine oxidase inhibitor|Tyrosine hydroxylase inhibitor
salubrinal	Eukaryotic translation initiation factor inhibitor
siguazodan	Phosphodiesterase inhibitor
sotalol	Adrenergic receptor antagonist
spiroxatrine	Serotonin receptor antagonist
splitomycin	SIRT inhibitor
SRC-kinase-inhibitor-I	Src inhibitor
suloctidil	Adrenergic receptor antagonist
tacrolimus	Calcineurin inhibitor
tadalafil	Phosphodiesterase inhibitor
TAS-301	Calcium/calmodulin dependent protein kinase inhibitor
TCS-359	FLT3 inhibitor
tebuthiuron	Photosynthesis inhibitor
teniposide	Topoisomerase inhibitor
tenoxicam	Cyclooxygenase inhibitor
terfenadine	Histamine receptor antagonist
testosterone	Androgen receptor agonist
tetrahydrocannabinol-7-oic-acid	Anti-inflammatory agent|Cannabinoid metabolite
tetrahydropalmatine	Serotonin release inhibitor
tetrahydrozoline	Adrenergic receptor agonist
tetramisole	Immunostimulant
thalidomide	TNF production inhibitor
thapsigargin	ATPase inhibitor
thiotepa	Cytochrome P450 inhibitor
ticlopidine	Purinergic receptor antagonist
tolazoline	Adrenergic receptor antagonist
tolmetin	Cyclooxygenase inhibitor
toltrazuril	Antiprotozoal agent
toremifene	Selective estrogen receptor modulator (SERM)|Estrogen receptor antagonist
tranylcypromine	Monoamine oxidase inhibitor
trazodone	Adrenergic receptor antagonist|Serotonin receptor antagonist|Serotonin reuptake inhibitor
triamcinolone	Glucocorticoid receptor agonist
triamcinolone-acetonide	Immunosuppressant|Corticosteroid agonist|Glucocorticoid receptor agonist
triciribine	AKT inhibitor
triclosan	Enoyl-[acyl-carrier-protein] reductase [NADH] inhibitor
triflupromazine	Dopamine receptor antagonist
alimemazine	Histamine receptor agonist
trimetozine	Sedative
trimipramine	Norepinephrine reputake inhibitor|Tricyclic antidepressant
triprolidine	Histamine receptor antagonist
tropicamide	Acetylcholine receptor antagonist
tubocurarine	Acetylcholine receptor antagonist
talampicillin	Bacterial cell wall synthesis inhibitor
tamoxifen	Estrogen receptor antagonist|Selective estrogen receptor modulator (SERM)
tetrabenazine	Vesicular monoamine transporter inhibitor
tetrindole	Monoamine oxidase inhibitor
thiethylperazine	Dopamine receptor antagonist
thiorphan	Membrane metalloendopeptidase inhibitor
tianeptine	Selective serotonin reuptake enhancer (SSRE)
tiaprofenic-acid	Cyclooxygenase inhibitor
tocainide	Sodium channel blocker
torasemide	Electrolyte reabsorption inhibitor|Thromboxane receptor antagonist
trequinsin	Phosphodiesterase inhibitor
tribenoside	Anti-inflammatory agent|Capillary stabilizing agent
tropisetron	Serotonin receptor antagonist
U-54494A	Opioid receptor agonist
U-0124	MEK inhibitor
VAMA-37	DNA dependent protein kinase inhibitor
MAZ-51	VEGFR inhibitor
venlafaxine	Serotonin reuptake inhibitor|Adrenergic inhibitor|Norepinephrine reuptake inhibitor
verteporfin	Photosensitizing agent
W-5	Calmodulin antagonist
warfarin	Vitamin K antagonist
WAY-161503	Serotonin receptor agonist
WAY-629	Serotonin receptor agonist
wortmannin	PI3K inhibitor
XE-991	Potassium channel blocker
Y-26763	Potassium channel activator
Y-27152	Potassium channel activator
Y-27632	Rho associated kinase inhibitor
YM-298198	Glutamate receptor antagonist
YM-90709	IL5 inhibitor
yohimbine	Adrenergic receptor antagonist
ZD-7114	Adrenergic receptor agonist
ZK-756326	CC chemokine receptor ligand
ZM-39923	JAK inhibitor
zoxazolamine	Myorelaxant
zacopride	Serotonin receptor antagonist
zamifenacin	Acetylcholine receptor antagonist
zimelidine	Serotonin reuptake inhibitor
zonisamide	Sodium channel blocker|T-type calcium channel blocker
aristolochic-acid	Phospholipase inhibitor
calyculin	Protein phosphatase inhibitor
cercosporin	Photoactivated toxin
epibatidine	Acetylcholine receptor agonist
epitestosterone	Inactive testosterone analog
fluphenazine	Dopamine receptor antagonist
fulvestrant	Estrogen receptor antagonist
geldanamycin	HSP inhibitor
manumycin-a	Farnesyltransferase inhibitor|NFkB pathway inhibitor
mitoxantrone	Topoisomerase inhibitor
nor-binaltorphimine	Opioid receptor antagonist
O-3M3FBS	Phospholipase activator
sirolimus	MTOR inhibitor
thioridazine	Dopamine receptor antagonist
trichostatin-a	HDAC inhibitor|CDK expression enhancer|ID1 expression inhibitor
trifluoperazine	Dopamine receptor antagonist
vorinostat	HDAC inhibitor
quinpirol-(-)	Dopamine receptor agonist
maackiain	Sodium/glucose cotransporter inhibitor
limonin	HIV protease inhibitor
osthol	Calcium channel blocker
cephaeline	Protein synthesis inhibitor
umbelliferone	Cyclooxygenase inhibitor
emodic-acid	Laxative
tyrphostin-AG-18	EGFR inhibitor|Tyrosine kinase inhibitor
AG-490	EGFR inhibitor|ErbB2 inhibitor|JAK inhibitor
tyrphostin-AG-494	EGFR inhibitor
AG-494	EGFR inhibitor|Tyrosine kinase inhibitor
tyrphostin-AG-538	IGF-1 inhibitor
tyrphostin-AG-555	EGFR inhibitor
tyrphostin-AG-556	EGFR inhibitor
AG-592	Tyrosine kinase inhibitor
tyrphostin	EGFR inhibitor
tyrphostin-AG-825	Receptor tyrosine protein kinase inhibitor
tyrphostin-1	EGFR inhibitor
tyrphostin-AG-1296	FLT3 inhibitor
tyrphostin-AG-1478	EGFR inhibitor
AG-370	PDGFR tyrosine kinase receptor inhibitor
tyrphostin-AG-879	Tyrosine kinase inhibitor|Angiogenesis inhibitor|VEGFR inhibitor
alverine	Muscle relaxant
AM-251	Cannabinoid receptor antagonist
AM-404	Cyclooxygenase inhibitor|FAAH inhibitor|TRPV antagonist
AM-630	Cannabinoid receptor antagonist
AM-92016	Potassium channel blocker
AM-580	Retinoid receptor agonist
amantadine	Glutamate receptor antagonist
amitriptyline	Norepinephrine inhibitor|Norepinephrine reuptake inhibitor|Serotonin receptor antagonist|Serotonin reuptake inhibitor
AMN-082	Glutamate receptor positive allosteric modulator|Glutamate receptor modulator
aminomethyltransferase	Nitric oxide synthase inhibitor
anandamide	Cannabinoid receptor agonist
androsta-1,4-dien-3,17-dione	Aromatase inhibitor
methyl-angolensate	Apoptosis inhibitor
AQ-RA741	Acetylcholine receptor antagonist
arachidonamide	Cannabinoid receptor agonist
auraptene	Nitric oxide production inhibitor
austricine	Hypolipidemic
AY-9944	Hedgehog pathway modulator
AZ-10417808	Caspase inhibitor
alfadolone-acetate	GABA receptor agonist
aloisine	CDK inhibitor|CFTR channel agonist|Glycogen synthase kinase inhibitor
alprostadil	Prostanoid receptor agonist
altanserin	Serotonin receptor antagonist
amiloride	Sodium channel blocker
aminogenistein	Src inhibitor
aminopurvalanol-a	Tyrosine kinase inhibitor|CDK inhibitor
amthamine	Histamine receptor agonist
anabasine	Acetylcholine receptor agonist
angiogenesis-inhibitor	Angiogenesis inhibitor
aniracetam	Glutamate receptor agonist
anisomycin	DNA synthesis inhibitor
apoptosis-activator-II	Carboxylesterase inhibitor
arctigenin	MEK inhibitor
arecaidine-but-2-ynyl-ester	Acetylcholine receptor agonist
arecaidine-propargyl-ester	Acetylcholine receptor agonist
arvanil	TRPV agonist
azacyclonol	Histamine receptor antagonist
talipexole	Adrenergic receptor agonist|Dopamine receptor agonist
baccatin-III	Paclitaxel precursor
baeomycesic-acid	Lipoxygenase inhibitor
BAPTA-AM	Potassium channel blocker
BAY-36-7620	Glutamate receptor antagonist
BAY-59-3074	Cannabinoid receptor partial agonist
BD-1008	Sigma receptor antagonist
BD-1047	Adrenergic receptor antagonist
BD-1063	Sigma receptor antagonist
benzanthrone	Aromatic hydrocarbon derivative
benzo(a)pyrene	Carcinogen
betahistine	Histamine receptor agonist|Histamine receptor antagonist
bezafibrate	PPAR receptor agonist
bicalutamide	Androgen receptor antagonist
biochanin-a	Estrogen receptor agonist
BML-190	Cannabinoid receptor inverse agonist
BML-257	AKT inhibitor|HCV inhibitor
BMS-191011	Potassium channel activator
BMY-14802	Sigma receptor antagonist
BMY-7378	Adrenergic receptor antagonist|Serotonin receptor antagonist
BP-554	Serotonin receptor agonist
BRL-15572	Serotonin receptor antagonist
BRL-37344	Adrenergic receptor agonist
BRL-50481	Phosphodiesterase inhibitor
BRL-54443	Serotonin receptor agonist
BU-239	Imidazoline receptor agonist|Imidazoline ligand
buddleoflavonoloside	Acetylcholinesterase inhibitor
bumetanide	Solute carrier family member inhibitor
butoconazole	Bacterial cell wall synthesis inhibitor
BW-723C86	Serotonin receptor agonist
BAY-11-7082	NFkB pathway inhibitor
BCL2-inhibitor	BCL inhibitor
beclomethasone-dipropionate	Immunosuppressant|Glucocorticoid receptor agonist
bemegride	Chemoreceptor agonist
oxybuprocaine	Local anesthetic
benperidol	Dopamine receptor antagonist
ubenimex	Leukotriene inhibitor
betaxolol	Adrenergic receptor antagonist
bifemelane	Acetylcholine release stimulant
biotin	Vitamin B
bis-tyrphostin	EGFR inhibitor
boldine	Acetylcholine receptor antagonist|Dopamine receptor antagonist
brefeldin-a	Protein synthesis inhibitor|Brefeldin A inhibited guanine nucleotide exchange protein inhibitors|Golgi-specific brefeldin A-resistance guanine nucleotide exchange factor inhibitor
brinzolamide	Carbonic anhydrase inhibitor
butabindide	Tripeptidyl peptidase inhibitor
butein	EGFR inhibitor|Src inhibitor
carbacyclin	IP receptor activator|PPAR receptor agonist
carbenoxolone	11-beta-HSD1 inhibitor
carbofuran	Cholinesterase inhibitor
carprofen	Cyclooxygenase inhibitor
catechin	Beta secretase inhibitor|Fatty acid synthase inhibitor|LDL antioxidants
CCCP	Mitochondrial oxidative phosphorylation uncoupler
CCMQ	Inhibitor of the binding of homoquinolinic acid to non-NMDA sensitive sites
CCT-018159	HSP inhibitor
CDC	Lipoxygenase inhibitor
cephalotaxine	Protein synthesis inhibitor
cetirizine	Histamine receptor antagonist
CFM-1571	Guanylate cyclase activator
CGK-733	ATM kinase inhibitor|ATR kinase inhibitor
CGP-12177	Adrenergic receptor agonist
CGP-13501	GABA receptor modulator
CGP-20712	Adrenergic receptor antagonist
CGP-37157	L-type calcium channel blocker|Sodium/calcium exchange inhibitor|Mitochondrial Na+/Ca2+ exchanger antagonist
CGP-52432	GABA receptor antagonist
CGP-53353	EGFR inhibitor|PKC inhibitor
CGP-55845	GABA receptor antagonist
CGP-71683	Neuropeptide receptor antagonist
CGP-7930	GABA receptor modulator|GABA receptor positive allosteric modulator
CGS-12066B	Serotonin receptor agonist
CGS-20625	Benzodiazepine receptor agonist
CGS-21680	Adenosine receptor agonist
zaldaride	Calmodulin antagonist
proguanil	Dihydrofolate reductase inhibitor
CI-966	GAT inhibitor
ciglitazone	PPAR receptor agonist
CL-218872	GABA receptor agonist
CL-82198	Metalloproteinase inhibitor
cosmosiin	Cytochrome P450 inhibitor
coumaric-acid	Antioxidant
CP-55940	Cannabinoid receptor agonist
CP-93129	Serotonin receptor agonist
CP-94253	Serotonin receptor agonist
CPCCOEt	Glutamate receptor antagonist
irinotecan	Topoisomerase inhibitor
crotamiton	Antipruritic
indolophenanthridine	CALY activator
cymarin	ATPase inhibitor
cabergoline	Dopamine receptor agonist
caffeic-acid	HIV integrase inhibitor|Lipoxygenase inhibitor|Nitric oxide production inhibitor|NFkB pathway inhibitor|PPAR receptor modulator|Tumor necrosis factor production inhibitor|TNF production inhibitor
calycanthine	GABA release inhibitor
camptothecin	Topoisomerase inhibitor
potassium-canrenoate	Mineralocorticoid receptor antagonist
capsazepine	TRPV agonist
cardiogenol-c	Cardiomyogenesis inducer
carmoxirole	Dopamine receptor agonist
carteolol	Adrenergic receptor antagonist
NSC-693868	CDK inhibitor|Glycogen synthase kinase inhibitor
CDK2-5-inhibitor	CDK inhibitor
cefixime	Bacterial cell wall synthesis inhibitor
ceforanide	Penicillin binding protein inhibitor
cefotiam	Bacterial cell wall synthesis inhibitor
clomethiazole	GABA receptor antagonist|GABA receptor modulator
cilastatin	Dehydropeptidase inhibitor
cilnidipine	Calcium channel blocker
cilostamide	Phosphodiesterase inhibitor
cinalukast	Leukotriene receptor antagonist
cinnarizine	Calcium channel blocker
ciprofibrate	PPAR receptor agonist
cirazoline	Adrenergic receptor agonist
clobenpropit	Histamine receptor antagonist
clocortolone-pivalate	Steroid
clofarabine	Ribonucleoside reductase inhibitor
clofibric-acid	PPAR receptor agonist
clomipramine	Serotonin transporter (SERT) inhibitor
clozapine	Serotonin receptor antagonist|Dopamine receptor antagonist
CO-102862	Sodium channel blocker
cromakalim	Potassium channel activator
cucurbitacin-i	JAK inhibitor|Lipocortin synthesis stimulant|STAT inhibitor
ciclacillin	Bacterial cell wall synthesis inhibitor
cyclo-[Arg-Gly-Asp-D-Phe-Val]	Integrin antagonist
cyclopenthiazide	Thiazide diuretic
cyproterone	Androgen receptor antagonist
D-4476	TGF beta receptor inhibitor
D-64131	Microtubule inhibitor
dactinomycin	RNA polymerase inhibitor
dantron	Laxative
DAPT-GSI-IX	Gamma secretase inhibitor
DAU-5884	Acetylcholine receptor antagonist
1,2-dichlorobenzene	Hepatotoxicant|Organic compound
DCEBIO	Potassium channel activator
deguelin	NADH-ubiquinone oxidoreductase (Complex I) inhibitor
deoxycorticosterone-acetate	Progestogen hormone
decafluorobutane	Contrast agent
DH-97	Melatonin receptor antagonist
benzydamine	Prostanoid receptor antagonist
diazepam	Benzodiazepine receptor agonist
dibenzepin	Norepinephrine reuptake inhibitor
dichlorobenzamil	Sodium/calcium exchange inhibitor
dictamnine	Furoquinoline alkaloid
dicyclohexylurea	Epoxide hydolase inhibitor
diethyltoluamide	DEET, activator of fly antenna ionotropic receptor IR40a
tubaic-acid	Mitochondrial complex I inhibitor|NADH-ubiquinone oxidoreductase (Complex I) inhibitor
dipropyl-5ct	Serotonin receptor agonist
diprotin-a	Dipeptidyl peptidase inhibitor
DMAB-anabaseine	Adrenergic receptor agonist
DMP-543	Acetylcholine release stimulant
DMeOB	Glutamate receptor modulator
DNQX	Glutamate receptor antagonist
BP-897	Dopamine receptor agonist
doconexent	PPAR receptor agonist
docosatrienoic-acid	LTB4 inhibitor
diarylpropionitrile	Estrogen receptor agonist
DPPE	Histamine receptor antagonist
DR-2313	PARP inhibitor
ditolylguanidine	Sigma receptor agonist
DY-131	Estrogen receptor agonist|Estrogen-related receptor agonist
dantrolene	Calcium channel blocker
dehydroisoandosterone	GABA receptor modulator
delcorine	Antiarrhythmic|Ganglionic blocker
deltaline	Acetylcholine receptor antagonist
denbufylline	Phosphodiesterase inhibitor
desoxycortone	Mineralocorticoid receptor agonist
devazepide	CCK receptor antagonist
diazoxide	Potassium channel activator
diclofenamide	Carbonic anhydrase inhibitor
diflorasone	Glucocorticoid receptor agonist
digoxigenin	Steroid
quinisocaine	Local anesthetic
diphenidol	Acetylcholine receptor agonist
diphenyleneiodonium	Nitric oxide synthase inhibitor
dobutamine	Adrenergic receptor agonist
dosulepin	Norepinephrine reuptake inhibitor|Serotonin reuptake inhibitor|Tricyclic antidepressant
DUP-697	Cyclooxygenase inhibitor
dydrogesterone	Progesterone receptor agonist
EBPC	Aldose reductase inhibitor
eriochrome-black-t	Azo dye used in titrations to detect metal ions
econazole	Lanosterol demethylase inhibitor|Sterol demethylase inhibitor|Bacterial cell wall synthesis inhibitor
EHNA	Adenosine deaminase inhibitor
eicosatrienoic-acid	Vasodilator
enalapril	Angiotensin converting enzyme inhibitor
enrofloxacin	Bacterial DNA gyrase inhibitor
EO-1428	P38 MAPK inhibitor
ER-27319	Mediator release inhibitor|SYK inhibitor
ergocornine	Dopamine receptor agonist
ergometrine	Adrenergic receptor agonist|Serotonin receptor agonist
eriodictyol	Cytochrome P450 inhibitor
erythromycin	NFkB pathway inhibitor
estradiol-valerate	Estrogen receptor agonist
BRD-K49061529	GABA benzodiazepine site receptor inverse agonist
eugenitol	Androgen receptor antagonist|Bacterial quorum sensing inhibitor|Chromone|Monoamine oxidase inhibitor
embelin	HCV inhibitor|XIAP inhibitor
epirizole	Cyclooxygenase inhibitor
eplerenone	Cytochrome P450 inhibitor
esculin	Antioxidant
ethisterone	Progestogen hormone
mestranol	Estrogen receptor agonist
etifenin	Compound used in hepatobiliary scans of the liver
evoxine	Furoquinoline alkaloid
EXO-1	ARF inhibitor
farnesylthioacetic-acid	Inhibitor of methyl esterification of farnesylated proteins
FCCP	Mitochondrial oxidative phosphorylation uncoupler
febuxostat	Xanthine oxidase inhibitor
fenbendazole	Tubulin inhibitor
fenofibrate	PPAR receptor agonist
finasteride	5 alpha reductase inhibitor
FIT	Opioid receptor agonist
FK-888	Tachykinin antagonist
flavokavain-b	Anticancer agent
fluconazole	Sterol demethylase inhibitor
flufenamic-acid	Chloride channel blocker
flumetasone	Glucocorticoid receptor agonist
flunisolide	Cytochrome P450 inhibitor
fluperlapine	Serotonin receptor antagonist
fluprostenol	Prostanoid receptor agonist
fludroxycortide	Glucocorticoid receptor agonist
FPL-55712	Leukotriene receptor antagonist
FPL-64176	Calcium channel activator
FR-122047	Cyclooxygenase inhibitor
FR-139317	Endothelin receptor antagonist
fraxidin	Carbonic anhydrase inhibitor
farnesylthiotriazole	PPMTase inhibitor
fananserin	Dopamine receptor antagonist|Serotonin receptor antagonist
fasudil	Rho associated kinase inhibitor
felbamate	Glutamate receptor antagonist
felodipine	Calcium channel blocker
fenobam	Glutamate receptor antagonist
fenoldopam	Dopamine receptor agonist
fenretinide	Apoptosis stimulant|Retinoid receptor agonist
fexaramine	FXR agonist
fillalbin	Increases arterial blood pressure
flavoxate	Acetylcholine receptor antagonist
flucloxacillin	Bacterial cell wall synthesis inhibitor
flumazenil	Benzodiazepine receptor antagonist
flurofamide	Urease inhibitor
fluticasone	Glucocorticoid receptor agonist
fluticasone-propionate	Glucocorticoid receptor agonist
fluvoxamine	Selective serotonin reuptake inhibitor (SSRI)
foliosidine	Plant alkaloid
formoterol	Adrenergic receptor agonist
fusaric-acid	Dopamine beta hydroxylase inhibitor
gamma-linolenic-acid	Cyclooxygenase inhibitor|Prostanoid receptor agonist
ganglioside	Src activator
GBR-12783	Dopamine uptake inhibitor
vanoxerine	Dopamine uptake inhibitor
GBR-12935	Dopamine uptake inhibitor
GBR-13069	Dopamine uptake inhibitor
glipizide	Sulfonylurea
GP-1a	Cannabinoid receptor agonist
GP-2a	Cannabinoid receptor agonist
GR-127935	Serotonin receptor antagonist
GR-144053	Integrin antagonist
GR-159897	Tachykinin antagonist
GR-32191	Thromboxane receptor antagonist
GR-46611	Serotonin receptor agonist
GR-55562	Serotonin receptor antagonist
GR-79236	Adenosine receptor agonist
GR-89696	Opioid receptor agonist
GS-39783	GABA receptor modulator
AR-A014418	Glycogen synthase kinase inhibitor
GTP-14564	FLT3 inhibitor|Tyrosine kinase inhibitor
GW-0742	PPAR receptor agonist|Insulin sensitizer
GW-311616	Leukocyte elastase inhibitor
GW-405833	Cannabinoid receptor agonist
GW-441756	Growth factor receptor inhibitor
GW-583340	Receptor tyrosine protein kinase inhibitor|EGFR inhibitor|ErbB2 inhibitor
GW-6471	PPAR receptor antagonist
GW-843682X	PLK inhibitor
GW-9508	Free Fatty Acid Receptor 1 (FFAR1; GPR40) Agonists|G protein coupled receptor agonist|Free fatty acid receptor agonist|G protein-coupled receptor agonist
GW-9662	PPAR receptor antagonist
GYKI-52466	Glutamate receptor antagonist|Kainate receptor antagonist
gabexate	Serine protease inhibitor
gavestinel	Glutamate receptor antagonist
genistein	Tyrosine kinase inhibitor
MD-920	NFkB pathway inhibitor
glibenclamide	Sulfonylurea
glimepiride	Insulin secretagogue
gliquidone	Sulfonylurea
guggulsterone	Estrogen receptor agonist|FXR antagonist|Progesterone receptor agonist|Cholesterol inhibitor|IKK inhibitor|Pregnane X receptor agonist
H-89	PKA inhibitor
H-8	PKA inhibitor
H-9	PKA inhibitor
HA-1004	Calcium channel blocker
BE-2254	Adrenergic receptor antagonist
hemado	Adenosine receptor agonist
herniarin	Acetylcholinesterase inhibitor
quercetagetin	PIM kinase inhibitor
homosalate	HSP inducer
hydrastine-(1r,-9s)	Tyrosine hydroxylase inhibitor
hydrocortisone	Glucocorticoid receptor agonist
hydrocortisone-valerate	Corticosteroid agonist|Glucocorticoid receptor agonist
hydroquinidine	Antiarrhythmic
halcinonide	Glucocorticoid receptor agonist
harpagoside	Acetylcholinesterase inhibitor
hesperidin	Flavanone glycoside
hexylcaine	Sodium channel blocker
hinokitiol	Tyrosinase inhibitor
hippeastrine	Plant alkaloid
hispidin	PKC inhibitor
bisbenzimide	DNA binding agent
homoharringtonine	Protein synthesis inhibitor
hydralazine	Vasodilator
hydrastinine	Haemostatic agent
IAA-94	Chloride channel blocker
IBC-293	Hydroxycarboxylic acid receptor agonist
BRD-A89208012	Thromboxane receptor antagonist
ICI-162846	Histamine receptor antagonist
BRD-A51929314	Thromboxane receptor antagonist
ICI-199441	Opioid receptor agonist
ICI-89406	Adrenergic receptor antagonist
IKK-16	IKK inhibitor
IKK-2-inhibitor-V	IKK inhibitor|NFkB pathway inhibitor
imperatorin	CDK inhibitor
indole-3-carbinol	Aryl hydrocarbon receptor agonist|Indoleamine 2,3-dioxygenase inhibitor
irilin-a	Isoflavone
IRL-2500	Endothelin receptor antagonist
isamoltane	Adrenergic receptor antagonist
isoeugenol	Nitric oxide production inhibitor
isoreserpine	Vesicular monoamine transporter inhibitor
isorotenone	Mitochondrial complex I inhibitor|NADH-ubiquinone oxidoreductase (Complex I) inhibitor
ITE	Aryl hydrocarbon receptor agonist
ivermectin	GABA receptor agonist
ibudilast	Phosphodiesterase inhibitor|Leukotriene receptor antagonist
immepip	Histamine receptor agonist
iobenguane	Antineoplastic agent
adipiodone	Contrast agent
iodophenpropit	Histamine receptor antagonist
ioxaglic-acid	Radiopaque medium
irsogladine	Phosphodiesterase inhibitor
isocarboxazid	Monoamine oxidase inhibitor
isoflupredone-acetate	Glucocorticoid receptor agonist
sulmazole	Adenosine receptor antagonist
ivachtin	Caspase inhibitor
J-104129	Acetylcholine receptor antagonist
JAK3-inhibitor-I	JAK inhibitor
WHI-P154	JAK inhibitor
JAK3-inhibitor-V	JAK inhibitor
JAK3-inhibitor-VI	JAK inhibitor
JLK-6	Gamma secretase inhibitor|Antiamyloidogenic agent
JNJ-10191584	Histamine receptor antagonist
JNJ-16259685	Glutamate receptor antagonist
JTE-013	Lysophospholipid receptor antagonist
JTE-907	Cannabinoid receptor inverse agonist
JWH-015	Cannabinoid receptor agonist
JX-401	P38 MAPK inhibitor
kavain	Calcium channel modulator|Sodium channel blocker
KB-R7943	Sodium/calcium exchange inhibitor
ketoprofen	Cyclooxygenase inhibitor
KF-38789	P selectin inhibitor
KN-62	Calcium/calmodulin dependent protein kinase inhibitor|Purinergic receptor antagonist
KN-93	Calcium/calmodulin dependent protein kinase inhibitor
KU-14R	Putative I3 antagonist|Imidazoline ligand
kynuramine	Aryl hydrocarbon receptor activator
kenpaullone	CDK inhibitor|Glycogen synthase kinase inhibitor
ketanserin	Serotonin receptor antagonist
L-368899	Oxytocin receptor antagonist
L-655240	Thromboxane receptor antagonist
vesamicol	Acetylcholinesterase inhibitor
L-152804	Neuropeptide receptor antagonist
L-165041	PPAR receptor agonist
L-689560	Glutamate receptor antagonist
L-692585	Growth hormone releasing peptide ligand agonist
L-693403	Sigma receptor agonist|Sigma receptor antagonist
L-694247	Serotonin receptor agonist
L-701252	Glutamate receptor antagonist
L-732138	Tachykinin antagonist
L-733060	Tachykinin antagonist
L-741626	Dopamine receptor antagonist
L-745870	Dopamine receptor antagonist
L-750667	Dopamine receptor antagonist
L-803087	Somatostatin receptor agonist
lavendustin-a	EGFR inhibitor
lawsone	Coloring agent
LE-135	Retinoid receptor agonist
LE-300	Dopamine receptor antagonist
LFM-A12	EGFR inhibitor
LFM-A13	BTK inhibitor
lidocaine	Histamine receptor agonist
linoleamide	ACAT inhibitor
alpha-linolenic-acid	Omega 3 fatty acid stimulant
lonidamine	Glucokinase inhibitor
losartan	Angiotensin receptor antagonist
lovastatin	HMGCR inhibitor
LY-2183240	FAAH inhibitor|FAAH reuptake inhibitor
LY-225910	CCK receptor antagonist
LY-288513	CCK receptor antagonist
LY-303511	Casein kinase inhibitor|PI3K inhibitor
LY-320135	Cannabinoid receptor antagonist
LY-341495	Glutamate receptor antagonist
LY-364947	TGF beta receptor inhibitor|P38 MAPK inhibitor
quinelorane	Dopamine receptor agonist
LY-165163	Serotonin receptor antagonist
LY-278584	Serotonin receptor antagonist
LY-255283	Leukotriene receptor antagonist
lysylphenylalanyl-tyrosine	Heparin activation inhibitor
lamotrigine	Serotonin receptor antagonist|Sodium channel blocker
leflunomide	Dihydroorotate dehydrogenase inhibitor|PDGFR tyrosine kinase receptor inhibitor
levcromakalim	Potassium channel activator
levocabastine	Histamine receptor antagonist
lidoflazine	Calcium channel blocker
roquinimex	Angiogenesis inhibitor|TNF production inhibitor
lobelanidine	Acetylcholine receptor antagonist|Dopamine receptor modulator|Opioid receptor antagonist|Vesicular monoamine transporter ligand
loperamide	Opioid receptor agonist
loreclezole	GABA receptor agonist
lumicolchicine	Colchicine isomer, non-binder of microtubules
luzindole	Melatonin receptor antagonist
lylamine	Cannabinoid receptor agonist
lysergol	Ergoline alkaloid
mammea-a	Other antibiotic
MAPP-D-erythro	Ceramidase inhibitor
L-erythro-MAPP	Negative control for D-erythro-MAPP
bemesetron	Serotonin receptor antagonist
MDL-72832	Serotonin receptor agonist
MDL-28170	Calpain inhibitor
MDM2-inhibitor	MDM inhibitor
mead-acid	KPL-1 tumor suppressor
mead-ethanolamide	Cannabinoid receptor agonist
mebendazole	Tubulin inhibitor
meclizine	Constitutive androstane receptor (CAR) agonist
meclofenamic-acid	Cyclooxygenase inhibitor|Prostanoid receptor antagonist
medrysone	Glucocorticoid receptor agonist
mefenamic-acid	Cyclooxygenase inhibitor
mefexamide	Psychoactive drug
megestrol-acetate	Progesterone receptor agonist|DNA inhibitor
MEK1-2-inhibitor	MEK inhibitor
mesoridazine	Dopamine receptor antagonist
metaxalone	Muscle relaxant
methocarbamol	Muscle relaxant
methoprene-acid	Retinoid receptor agonist
BRD-K14844937	GABA benzodiazepine site receptor inverse agonist
BRD-K28680267	CCK receptor antagonist
methylnorlichexanthone	Aurora kinase inhibitor|PIM kinase inhibitor|VEGFR inhibitor
metoclopramide	Dopamine receptor antagonist|Serotonin receptor antagonist
metoprolol	Adrenergic receptor antagonist
MG-132	Proteasome inhibitor
minoxidil	KATP activator|Kir6 channel (KATP) activator|Vasodilator
ML-3163	P38 MAPK inhibitor
ML-7	Myosin light chain kinase inhibitor
MMPX	Phosphodiesterase inhibitor
MNITMT	Lymphocyte inhibitor
modafinil	Adrenergic receptor agonist
LY-456236	Glutamate receptor antagonist
MR-16728	Acetylcholine release stimulant|Acetylcholine release enhancer
MRS-1220	Adenosine receptor antagonist
MRS-1754	Adenosine receptor antagonist
MRS-1845	Calcium channel blocker
MT-21	Caspase activator
MY-5445	Phosphodiesterase inhibitor|Platelet aggregation inhibitor
mycophenolate-mofetil	Inosine monophosphate dehydrogenase inhibitor|Hydroxycarboxylic acid receptor agonist|Immunosuppressant|Dehydrogenase inhibitor|Inositol monophosphatase inhibitor
malonoben	Protein tyrosine kinase inhibitor
meclocycline	Bacterial 30S ribosomal subunit inhibitor
melperone	Dopamine receptor antagonist|Serotonin receptor antagonist
meprylcaine	Local anesthetic
meptazinol	Opioid receptor agonist
methantheline	Acetylcholine receptor antagonist
levomepromazine	Dopamine receptor antagonist
methyllycaconitine	Acetylcholine receptor antagonist
mevastatin	HMGCR inhibitor
mianserin	Serotonin receptor antagonist
mibefradil	T-type calcium channel blocker
mifepristone	Glucocorticoid receptor antagonist|Progesterone receptor antagonist
milrinone	Phosphodiesterase inhibitor
moexipril	Angiotensin converting enzyme inhibitor
molsidomine	Guanylyl cyclase activator
mometasone	Glucocorticoid receptor agonist
monastrol	Kinesin inhibitor
moxonidine	Imidazoline receptor agonist
hexamethyleneamiloride	Sodium/hydrogen antiport inhibitor
Ro-16-6941	Monoamine oxidase inhibitor
N-arachidonyl-GABA	Cannabinoid receptor agonist
desmethylclozapine	Acetylcholine receptor agonist
N-methyllidocaine-iodide	Antiarrhythmic medication
BRD-K17693482	Potassium channel activator
BRD-K71726959	CDK inhibitor
NAN-190	Serotonin receptor agonist
naphazoline	Adrenergic receptor agonist
NAS-181	Serotonin receptor antagonist
nateglinide	Insulin secretagogue
NBI-27914	CRF receptor antagonist
NECA	Adenosine receptor agonist
nefopam	Cyclooxygenase inhibitor
NGB-2904	Dopamine receptor antagonist
niguldipine	Adrenergic receptor antagonist|Calcium channel blocker
nilutamide	Androgen receptor antagonist
nizatidine	Histamine receptor antagonist
NNC-05-2090	GAT inhibitor|GABA uptake inhibitor
BRD-K08438429	Somatostatin receptor agonist
NNC-55-0396	T-type calcium channel blocker
NNC-63-0532	Opioid receptor agonist
NNC-711	GAT inhibitor
nobiletin	MEK inhibitor
nomilin	HSP inhibitor
nonoxynol-9	Membrane integrity inhibitor
noreleagnine	Monoamine oxidase inhibitor|Serotonin receptor agonist
norethisterone	Progesterone receptor agonist
noretynodrel	Progestogen hormone
norgestrel	Progesterone receptor agonist
nortriptyline	Tricyclic antidepressant
noscapine	Bradykinin receptor antagonist|Tubulin inhibitor
NPC-15199	ICAM1 antagonist|ICAM 1 antagonist
NSC-3852	HDAC inhibitor
NSC-632839	Ubiquitin specific protease inhibitor
NSC-95397	CDC inhibitor
NTNCB	Neuropeptide receptor antagonist
buphenine	Adrenergic receptor agonist
tosyllysyl-chloromethyl-ketone	Chymotrypsin inhibitor
nafadotride	Dopamine receptor antagonist
nafcillin	Bacterial cell wall synthesis inhibitor
naftifine	Fungal squalene epoxidase inhibitor
naltriben	Opioid receptor antagonist
naltrindole	Opioid receptor antagonist
naproxen	Cyclooxygenase inhibitor
necrostatin-1	RIPK inhibitor
nefazodone	Serotonin receptor antagonist|Serotonin reuptake inhibitor|Adrenergic inhibitor|Norepinephrine reuptake inhibitor
nemonapride	Dopamine receptor antagonist
nifedipine	Calcium channel blocker
nifurtimox	DNA inhibitor
nimesulide	Cyclooxygenase inhibitor
nisoxetine	Norepinephrine reuptake inhibitor
nitrocaramiphen	Cholinergic receptor antagonist
nomegestrol-acetate	Progesterone receptor agonist
norcyclobenzaprine	Adrenergic receptor agonist|Serotonin receptor antagonist
levonorgestrel	Estrogen receptor agonist|Glucocorticoid receptor antagonist|Progesterone receptor agonist|Progesterone receptor antagonist
norketamine	Glutamate receptor antagonist
O-1918	Cannabinoid receptor antagonist
O-2050	Cannabinoid receptor antagonist
OBAA	Phospholipase inhibitor
ODQ	Guanylyl cyclase inhibitor
oleanolic-acid	G protein-coupled receptor agonist
OMDM-2	FAAH inhibitor
omeprazole	ATPase inhibitor
orphenadrine	Acetylcholine receptor antagonist
oxybenzone	Lipase inhibitor
olomoucine	CDK inhibitor
olvanil	TRPV agonist
oxindole-I	VEGFR inhibitor
oxymetazoline	Adrenergic receptor agonist
P-1075	ATP channel activator|Potassium channel activator
pantoprazole	ATPase inhibitor
papaverine	Phosphodiesterase inhibitor
parachlorophenol	Antiinfective drug
pargyline	Monoamine oxidase inhibitor
PCA-4248	Platelet activating factor receptor antagonist
PCO-400	Potassium channel activator
PD-102807	Acetylcholine receptor antagonist
PD-123319	Angiotensin antagonist
PD-160170	Neuropeptide receptor antagonist
PD-166793	Metalloproteinase inhibitor|Collagenase inhibitor
PD-169316	P38 MAPK inhibitor
PD-198306	MAP kinase inhibitor|MEK inhibitor
PD-407824	PKC inhibitor
PD-98059	MEK inhibitor|MAP kinase inhibitor
D-64406	PDGFR tyrosine kinase receptor inhibitor
penfluridol	T-type calcium channel blocker
pentoxifylline	Phosphodiesterase inhibitor
pentylenetetrazol	GABA receptor antagonist
peucedanin	Apoptosis stimulant
PG-9	Acetylcholine receptor agonist
PHA-665752	C-Met inhibitor
phenazopyridine	Local anesthetic
pheniramine	Histamine receptor antagonist
phenoxybenzamine	Adrenergic receptor antagonist
phentolamine	Adrenergic receptor antagonist
acetohydroxamic-acid	Urease inhibitor
phenylbutazone	Cyclooxygenase inhibitor|Prostanoid receptor antagonist
PHTPP	Estrogen receptor antagonist
PI-828	PI3K inhibitor
piceatannol	SYK inhibitor
pinacidil	ATP channel activator|Potassium channel activator
pinocembrin	CYP1B1 inhibitor
pirenzepine	Acetylcholine receptor antagonist
PIT	Purinergic receptor antagonist
PK-11195	Benzodiazepine receptor antagonist
midostaurin	FLT3 inhibitor|KIT inhibitor|PKC inhibitor
PNU-120596	Acetylcholine receptor agonist
PNU-22394	Serotonin receptor agonist
PNU-282987	Cholinergic receptor agonist
PNU-96415E	Dopamine receptor antagonist
podophyllotoxin	Microtubule inhibitor|Tubulin inhibitor
PP-1	Src inhibitor|Abl kinase inhibitor
PP-2	Src inhibitor
PP-3	EGFR inhibitor
PPT	Estrogen receptor agonist
PQ-401	IGF-1 inhibitor|Insulin growth factor receptor inhibitor
pravastatin	HMGCR inhibitor
prazosin	Adrenergic receptor antagonist
probenecid	Uricosuric blocker
probucol	Atherogenesis inhibitor
procainamide	Sodium channel blocker
prometon	Photosynthesis inhibitor
propafenone	Antiarrhythmic
propofol	GABA receptor agonist
beta-CCP	Indoleamine 2,3-dioxygenase inhibitor
prostaglandin-a1	HSP inducer|NFkB pathway inhibitor
prostaglandin-b2	CAMP inhibitor
prothionamide	Mycobacterium tuberculosis enoyl-[acyl-carrier-protein] reductase [NADH] (inhA) inhibitor
prunetin	Breast cancer resistance protein inhibitor
PSB-11	Adenosine receptor antagonist
pseudoephedrine	Adrenergic receptor agonist
psoromic-acid	Ras GTPase inhibitor
puromycin	Protein synthesis inhibitor
mepyramine	Histamine receptor antagonist
pyrimethamine	Dihydrofolate reductase inhibitor
palmitoylethanolamide	Cannabinoid receptor agonist
parthenolide	NFkB pathway inhibitor
phenanthridone	PARP inhibitor
phenformin	AMPK activator
phosphodiesterase-V-inhibitor-II	Phosphodiesterase inhibitor
picotamide	Thromboxane receptor antagonist|Thromboxane synthase inhibitor
picrotoxin	GABA receptor antagonist
pifithrin-alpha	TP53 inhibitor
pifithrin	Interleukin receptor antagonist
pimozide	Dopamine receptor antagonist
piperacetazine	Dopamine receptor antagonist
piretanide	Glucocorticoid receptor agonist
pirfenidone	TGF beta receptor inhibitor
pregnenolone	Glutamate receptor modulator
procarbazine	Monoamine oxidase inhibitor
procaterol	Adrenergic receptor agonist
proxymetacaine	Sodium channel blocker
propoxycaine	Local anesthetic
dinoprostone	Prostanoid receptor agonist
proxyfan	Histamine receptor modulator
pseudopelletierine	Anthelmintic agent
purmorphamine	Smoothened receptor agonist
pyrrolidine-dithiocarbamate	NFkB pathway inhibitor
quinidine	Sodium channel blocker
QX-314	Sodium channel blocker
quercetin	Polar auxin transport inhibitor
BRD-K84421793	Dopamine receptor agonist
BRD-K39187410	Antiamyloidogenic agent
morphothebaine	Adrenergic receptor antagonist
R-96544	Serotonin receptor antagonist
ranolazine	Sodium channel blocker
reserpine	Vesicular monoamine transporter inhibitor
REV-5901	Leukotriene receptor antagonist|Lipoxygenase inhibitor
RG-13022	PDGFR tyrosine kinase receptor inhibitor
RG-14620	EGFR inhibitor
RHC-80267	Triacylglycerol lipase inhibitor
roscovitine	CDK inhibitor
rosiglitazone	PPAR receptor agonist|Insulin sensitizer
rotenonic-acid	Retinoid receptor antagonist
RS-100329	Adrenergic receptor antagonist
RS-102221	Serotonin receptor antagonist
RS-16566	Serotonin receptor antagonist
RS-17053	Adrenergic receptor antagonist
RS-45041-190	Imidazoline receptor agonist
RS-504393	CC chemokine receptor antagonist
RS-56812	Serotonin receptor partial agonist
RS-67333	Serotonin receptor partial agonist
RS-67506	Serotonin receptor partial agonist
RWJ-21757	TLR agonist
ryanodine	Calcium channel blocker
racecadotril	Enkephalinase inhibitor
raclopride	Dopamine receptor antagonist
reboxetine	Adrenergic receptor antagonist
remacemide	Glutamate receptor antagonist
remoxipride	Dopamine receptor antagonist
rescinnamine	Angiotensin converting enzyme inhibitor
reserpic-acid	Norepinephrine transporter inhibitor
resveratrol	Cytochrome P450 inhibitor|SIRT activator
tretinoin	Retinoid receptor agonist|Retinoid receptor ligand
rilmenidine	Adrenergic receptor agonist|Imidazoline receptor agonist
riluzole	Glutamate inhibitor
rimcazole	Sigma receptor antagonist
rimexolone	Glucocorticoid receptor agonist
risperidone	Dopamine receptor antagonist|Serotonin receptor antagonist
Ro-04-5595	Glutamate receptor antagonist
Ro-08-2750	NGF binding inhibitor
Ro-10-5824	Dopamine receptor agonist
Ro-15-4513	GABA benzodiazepine site receptor inverse agonist
Ro-19-4605	GABA benzodiazepine site receptor inverse agonist
Ro-60-0175	Serotonin receptor agonist
rosmarinic-acid	GABA transaminase inhibitor
ryuvidine	Histone lysine methyltransferase inhibitor
terguride	Dopamine receptor agonist|Serotonin receptor antagonist
lisuride	Dopamine receptor agonist
ibuprofen-(S)	Cyclooxygenase inhibitor
salvinorin-a	Opioid receptor agonist
SANT-1	Smoothened receptor antagonist
sarmentogenin	ATPase inhibitor
SB-200646	Serotonin receptor antagonist
SB-202190	P38 MAPK inhibitor
SB-203580	P38 MAPK inhibitor
SB-205384	GABA receptor modulator
SB-205607	Delta 1 opioid receptor agonist
SB-218795	Tachykinin antagonist
SB-221284	Serotonin receptor antagonist
SB-222200	Tachykinin antagonist
SB-225002	CC chemokine receptor antagonist
SB-239063	P38 MAPK inhibitor
SB-269970	Serotonin receptor antagonist
SB-334867	Orexin receptor antagonist
SB-366791	TRPV antagonist
SB-408124	Orexin receptor antagonist
SB-415286	Glycogen synthase kinase inhibitor
SB-431542	TGF beta receptor inhibitor
SC-560	Cyclooxygenase inhibitor
SC-10	Protein kinase activator
IKK-2-inhibitor	IKK inhibitor|SYK inhibitor
SC-68376	P38 MAPK inhibitor
SC-9	Protein tyrosine kinase activator
scandenin	Plant compound with antimicrobiial activity
SCH-23390	Dopamine receptor antagonist
ecopipam	Dopamine receptor antagonist
SCH-442416	Adenosine receptor antagonist
SCH-58261	Adenosine receptor antagonist
scopolamine	Acetylcholine receptor antagonist
SDZ-205-557	Serotonin receptor antagonist
SDZ-21009	Adrenergic receptor antagonist|Serotonin receptor antagonist
SDZ-NKT-343	Tachykinin antagonist
SDZ-WAG-994	Adenosine receptor agonist
selinidin	Mast cell stabilizer
SEW-2871	Lysophospholipid receptor agonist
SIB-1757	Glutamate receptor antagonist
sinensetin	Cyclooxygenase inhibitor
skatole	Thrombin inhibitor
SKF-77434	Dopamine receptor agonist
SKF-81297	Dopamine receptor agonist
SKF-86002	P38 MAPK inhibitor
SKF-89976A	GABA uptake inhibitor
SKI-II	Sphingosine kinase inhibitor
pyrazolanthrone	JNK inhibitor
SQ-22536	Adenylyl cyclase inhibitor
SR-142948	Neurotensin receptor antagonist
SR-27897	CCK receptor antagonist
relcovaptan	Vasopressin receptor antagonist
SR-57227A	Serotonin receptor agonist
SR-59230A	Adrenergic receptor antagonist
SR-95639A	Acetylcholine receptor agonist
SSR-69071	Leukocyte elastase inhibitor
ST-91	Adrenergic receptor agonist
STO-609	Calmodulin antagonist
SU-4312	Tyrosine kinase inhibitor|PDGFR tyrosine kinase receptor inhibitor|VEGFR inhibitor
semaxanib	VEGFR inhibitor
SU-1498	VEGFR inhibitor
SU-6656	Src inhibitor
sulconazole	Sterol demethylase inhibitor
sulpiride	Dopamine receptor antagonist
saclofen	GABA receptor antagonist
salmeterol	Adrenergic receptor agonist
saquinavir	HIV protease inhibitor
scopolamine-n-oxide	Acetylcholine receptor antagonist
scoulerine	Adrenergic receptor antagonist|GABA receptor antagonist|Serotonin receptor antagonist
scriptaid	HDAC inhibitor
securinine	GABA receptor antagonist|TP53 activator
seneciphylline	Cytochrome P450 inhibitor
sertaconazole	Sterol demethylase inhibitor
skimmianine	Acetylcholinesterase inhibitor|Furoquinoline alkaloid
solanine	Acetylcholinesterase inhibitor
spironolactone	Mineralocorticoid receptor antagonist
SRC-kinase-inhibitor-II	Src inhibitor
ponalrestat	Aldose reductase inhibitor
strophanthidin	ATPase inhibitor
sulfafurazole	Bacterial antifolate
SYK-inhibitor	SYK inhibitor
syrosingopine	Vesicular monoamine transporter inhibitor
T-0070907	PPAR receptor antagonist
T-0156	Phosphodiesterase inhibitor
T-0901317	LXR agonist|ABC transporter expression enhancer|ROR inverse agonist
T-98475	Gonadotropin releasing factor hormone receptor antagonist
tangeritin	Cell cycle inhibitor
4,5,6,7-tetrabromobenzotriazole	Casein kinase inhibitor
TC-2559	Acetylcholine receptor agonist
TCB2	Serotonin receptor agonist
telmisartan	Angiotensin receptor antagonist
temefos	Cholinesterase inhibitor
TER-14687	Inhibitor of translocation of PKCq in T cells
testosterone-propionate	Androgen receptor agonist
tiabendazole	Angiogenesis inhibitor
thiothixene	Dopamine receptor antagonist
PCI-24781	HDAC inhibitor
tetramethylsilane	Internal standard for NMR spectroscopy
tolazamide	ATP channel blocker
tolbutamide	ATP channel blocker
tramadol	Opioid receptor agonist|Norepinephrine reputake inhibitor|Serotonin reuptake inhibitor
7-hydroxy-PIPAT	Dopamine receptor ligand
triamterene	Sodium channel blocker
trimethobenzamide	Histamine receptor antagonist
trioxsalen	DNA synthesis inhibitor
tripelennamine	Histamine receptor antagonist
thenoyltrifluoroacetone	Chelating agent
TTNPB	Retinoid receptor agonist
TWS-119	Glycogen synthase kinase inhibitor
tyrphostin-AG-99	Tyrosine kinase inhibitor
tyrphostin-47	EGFR inhibitor
tyrphostin-B44	EGFR inhibitor
talniflumate	Cyclooxygenase inhibitor
telenzepine	Acetylcholine receptor antagonist
tenidap	Cyclooxygenase inhibitor
terconazole	Sterol demethylase inhibitor
thiocolchicoside	GABA receptor antagonist
thioperamide	Histamine receptor antagonist
thioproperazine	Dopamine receptor antagonist
timolol	Adrenergic receptor antagonist
tiotidine	Histamine receptor antagonist
atomoxetine	Norepinephrine transporter inhibitor
tracazolate	GABA receptor modulator
tranilast	Angiogenesis inhibitor
trap-101	Opioid receptor antagonist|Nociceptin/orphanin FQ (NOP) receptor antagonist
trapidil	PDGFR tyrosine kinase receptor inhibitor
tremorine	Acetylcholine receptor agonist
tropanyl-3,5-dimethylbenzoate	Serotonin receptor antagonist
tyrphostin-AG-835	Protein tyrosine kinase inhibitor
U-18666A	Oxidosqualene cyclase inhibitor
U-99194	Dopamine receptor antagonist
U-0126	MEK inhibitor
U-46619	Thromboxane receptor agonist
U-74389F	Lipid peroxidase inhibitor
UB-165	Acetylcholine receptor agonist
UBP-302	Glutamate receptor antagonist
UCL-2077	Slow afterhyperpolarization channel blocker
brimonidine	Adrenergic receptor agonist
valsartan	Angiotensin receptor antagonist
vardenafil	Phosphodiesterase inhibitor
VEGF-receptor-2-kinase-inhibitor-IV	VEGFR inhibitor
verapamil	Calcium channel blocker
veratridine	Sodium channel activator
vinblastine	Microtubule inhibitor|Tubulin inhibitor
vincristine	Tubulin inhibitor
VUF-5681	Histamine receptor antagonist
vincamine	Adrenergic receptor antagonist
vinpocetine	Phosphodiesterase inhibitor|Sodium channel blocker
vitexin	Antioxidant
W-12	Calmodulin antagonist
W-13	Calmodulin antagonist
W-7	Calmodulin antagonist|Potassium channel blocker
W-9	Calmodulin antagonist
WAY-170523	Metalloproteinase inhibitor
WAY-213613	Glutamate inhibitor
apafant	Platelet activating factor receptor antagonist
WR-216174	PFMRK inhibitor
pirinixic-acid	PPAR receptor agonist
xanthoxyline	Other antifungal
xylazine	Adrenergic receptor agonist
xaliproden	Serotonin receptor agonist
Y-134	Estrogen receptor antagonist
azasetron	Serotonin receptor antagonist
YC-1	Guanylyl cyclase activator
YM-976	Phosphodiesterase inhibitor
YS-035	Calcium channel blocker
z-leu3-VS	Proteasome inhibitor
z-prolyl-prolinal	Prolyl endopeptidase inhibitor
ZD-2079	Adrenergic receptor agonist
ZD-7155	Angiotensin receptor antagonist
ZD-7288	HCN channel blocker
ZK-164015	Estrogen receptor antagonist
ZK-93423	Benzodiazepine receptor agonist
ZK-93426	Benzodiazepine receptor antagonist
ZM-241385	Adenosine receptor antagonist
ZM-306416	Abl kinase inhibitor|Src inhibitor|VEGFR inhibitor
ZM-323881	VEGFR inhibitor
zolmitriptan	Serotonin receptor agonist
zaprinast	Phosphodiesterase inhibitor
zardaverine	Phosphodiesterase inhibitor
zatebradine	HCN channel blocker
zolantidine	Histamine receptor antagonist
zuclopenthixol	Dopamine receptor antagonist
betulinic-acid	Apoptosis stimulant|Caspase activator|Diacylglycerol O acyltransferase inhibitor|HIV integrase inhibitor|NFkB pathway activator|SARS coronavirus 3C-like protease inhibitor|Topoisomerase inhibitor
bongkrek-acid	Mitochondrial ADP, ATP translocase inhibitor
bufalin	ATPase inhibitor
bulleyaconitine-a	Non-opiod analgesic
calpeptin	Calpain inhibitor
cinobufagin	ATPase inhibitor
flupentixol	Dopamine receptor antagonist
coumestrol	Estrogen receptor agonist
cyclopamine	Smoothened receptor antagonist
damnacanthal	Src inhibitor
dibutyrylcyclic-gmp	CGMP analog
formestane	Aromatase inhibitor
ginsenoside	Steroid hormone receptor agonist
mocimycin	Protein synthesis inhibitor
m-3M3FBS	Phospholipase activator
m-chlorophenylbiguanide	Serotonin receptor agonist
nTZDpa	PPAR receptor agonist
wiskostatin	Neural Wiskott-Aldrich syndrome protein inhibitor
alpha-estradiol	Estrogen receptor agonist
alvespimycin	HSP inhibitor
radicicol	HSP inhibitor
tanespimycin	HSP inhibitor
troglitazone	PPAR receptor agonist|Insulin sensitizer
valproic-acid	HDAC inhibitor
withaferin-a	IKK inhibitor
JTC-801	Opioid receptor antagonist
epigallocatechin	Nitric oxide synthase inhibitor
capsaicin	TRPV agonist
BAY-K-8644-(S)-(-)	L-type calcium channel activator
orteronel	Androgen biosynthesis inhibitor|Androgen receptor antagonist|Cytochrome P450 inhibitor
BAX-channel-blocker	Cytochrome C release inhibitor
itraconazole	Cytochrome P450 inhibitor
SN-38	Topoisomerase inhibitor
zileuton	Leukotriene inhibitor|Lipoxygenase inhibitor
oligomycin-a	ATP synthase inhibitor|ATPase inhibitor
BRD-A83255679	Estrogen receptor antagonist
RITA	MDM inhibitor
7-nitroindazole	Nitric oxide synthase inhibitor
alda-1	Aldehyde dehydrogenase activator
rotenone	Mitochondrial complex I inhibitor
NVP-BEZ235	MTOR inhibitor|PI3K inhibitor
XAV-939	Tankyrase inhibitor
PRIMA1	TP53 inhibitor
phloretin	Sodium/glucose cotransporter inhibitor
SCH-79797	Proteasome inhibitor
gossypol	BCL inhibitor|MCL1 inhibitor
4-iodo-6-phenylpyrimidine	Macrophage inhibitor
CD-1530	Retinoid receptor agonist
imiquimod	Interferon inducer|TLR agonist
cytochalasin-b	Microtubule inhibitor
CD-437	Retinoid receptor agonist
AGK-2	SIRT inhibitor
NVP-AUY922	HSP inhibitor
cerulenin	Fatty acid synthase inhibitor
tivozanib	VEGFR inhibitor
MK-1775	WEE1 kinase inhibitor
selumetinib	MEK inhibitor
FK-866	Niacinamide phosphoribosyltransferase inhibitor
serdemetan	MDM inhibitor
KO-143	Breast cancer resistance protein inhibitor
quinoclamine	Algicide
BRD-K68548958	Histone acetyltransferase inhibitor
PF-04217903	C-Met inhibitor
BRD-K89329876	Kinesin inhibitor
16,16-dimethylprostaglandin-e2	Prostanoid receptor agonist
BRD-K92980438	Hexokinase inhibitor
SJ-172550	MDM inhibitor
AC-55649	Retinoid receptor agonist
kinetin-riboside	Apoptosis stimulant
fatostatin	SREBP inhibitor
calcitriol	Vitamin D receptor agonist
BRD-K86682249	Tyrosine phosphatase inhibitor
15-delta-prostaglandin-j2	PPAR receptor agonist
BRD-K30064966	Caspase activator
triptolide	RNA polymerase inhibitor
9-methyl-5H-6-thia-4,5-diaza-chrysene-6,6-dioxide	NFkB pathway inhibitor
BRD-K98404142	Glucose 6-phosphate dehydrogenase inhibitor
2',5'-dideoxyadenosine	Adenylyl cyclase inhibitor
2-fluoropalmitic-acid	Palmitoyl-CoA biosynthesis inhibitor
CHEMBL-374350	NFkB pathway inhibitor
CHEMBL-399379	ATP citrase lyase inhibitor
RS-23597-190	Serotonin receptor antagonist
idarubicin	Topoisomerase inhibitor
PIK-75	DNA protein kinase inhibitor|PI3K inhibitor
7b-cis	Exportin antagonist
ABT-737	BCL inhibitor
navitoclax	BCL inhibitor
ABT-751	Tubulin inhibitor
veliparib	PARP inhibitor
tyrphostin-AG-112	Protein tyrosine kinase inhibitor
rucaparib	PARP inhibitor
AG-14361	PARP inhibitor
AICA-ribonucleotide	AMPK activator
APO-866	Niacinamide phosphoribosyltransferase inhibitor|NAMPT inhibitor
AS-605240	PI3K inhibitor
AZD-7545	Pyruvate dehydrogenase kinase inhibitor
olaparib	PARP inhibitor
AZD-8055	MTOR inhibitor
AKT-inhibitor-IV	AKT inhibitor
10-DEBC	AKT inhibitor
AKT-inhibitor-1-2	AKT inhibitor
3-amino-benzamide	PARP inhibitor
arachidonyl-trifluoro-methane	Cytosolic phospholipase inhibitor
bortezomib	NFkB pathway inhibitor|Proteasome inhibitor
BI-2536	PLK inhibitor
BIBR-1532	Telomerase inhibitor
pyrvinium-pamoate	Androgen receptor antagonist|AKT inhibitor
BML-259	CDK inhibitor
BMS-299897	Gamma secretase inhibitor
BMS-536924	IGF-1 inhibitor
BMS-641988	Androgen receptor antagonist
BMS-754807	IGF-1 inhibitor
BO2-inhibits-RAD51	RAD51 inhibitor
BX-795	IKK inhibitor
CAY-10594	Phospholipase inhibitor
CAY-10618	NAMPT inhibitor
tosedostat	Peptidase inhibitor
CI-976	ACAT inhibitor
CYT-997	Tubulin inhibitor
fluoropyruvate	Pyruvate dehydrogenase inhibitor
batimastat	Matrix metalloprotease inhibitor
DL-TBOA	Excitatory amino acid transporter inhibitor
AR-C133057XX	Nitric oxide synthase inhibitor
M2-PK-activator	Pyruvate kinase isozyme activator
curcumin	Cyclooxygenase inhibitor|Histone acetyltransferase inhibitor|Lipoxygenase inhibitor|NFkB pathway inhibitor
cytosporone-b	NUR77 receptor agonist
DG-041	Prostanoid receptor antagonist
DL-PDMP	Glucosyltransferase inhibitor
etomoxir	Carnitine palmitoyltransferase inhibitor
ERK-inhibitor-11E	MAP kinase inhibitor
EX-527	SIRT inhibitor
evodiamine	ATPase inhibitor|TRPV agonist
FTI-276	Farnesyltransferase inhibitor
fumonisin-b1	Sphingosine N acyltransferase inhibitor
GANT-58	GLI antagonist
GMX-1778	NAMPT inhibitor
GSK-2334470	Pyruvate dehydrogenase kinase inhibitor
ISOX	HDAC inhibitor
neratinib	EGFR inhibitor
HLI-373	MDM inhibitor
IKK-inhibitor-X	IKK inhibitor
IKK3-inhibitor-IX	IKK inhibitor
isoliquiritigenin	Guanylate cyclase activator
importazole	Importin-beta transport receptor inhibitor
ingenol	PKC activator
inhibitor-BEC	Arginase inhibitor
dalcetrapib	Cholesterylester transfer protein inhibitor
JZL-184	Monoacylglucerol lipase inhibitor
KU-0060648	DNA dependent protein kinase inhibitor|PI3K inhibitor
KU-0063794	MTOR inhibitor
L-690330	Inositol monophosphatase inhibitor
L-690488	Inositol monophosphatase inhibitor
sulforaphane	Anticancer agent|Aryl hydrocarbon receptor antagonist
sonidegib	Smoothened receptor antagonist
pemetrexed	Dihydrofolate reductase inhibitor|Thymidylate synthase inhibitor
lenalidomide	Anticancer agent
maraviroc	CC chemokine receptor antagonist
enzalutamide	Androgen receptor antagonist
methylene-blue	Nitric oxide production inhibitor|Monoamine oxidase inhibitor|Tau aggregation inhibitor|Guanylyl cyclase inhibitor
quiflapon	Leukotriene inhibitor
MK-2206	AKT inhibitor
ixazomib	Proteasome inhibitor
pevonedistat	Nedd activating enzyme inhibitor
MST-312	Telomerase inhibitor
NF-449	Purinergic receptor antagonist
NFKB-activation-inhibitor-II	NFkB pathway inhibitor
NU-1025	PARP inhibitor|DNA dependent protein kinase inhibitor
narciclasine	Coflilin signaling pathway activator|LIM kinase activator|Rho associated kinase activator
nutlin-3	MDM inhibitor
linsitinib	IGF-1 inhibitor
sparfosic-acid	Aspartate carbamoyltransferase inhibitor
phenethyl-isothiocyanate	Anticancer agent
perhexiline	Carnitine palmitoyltransferase inhibitor
PF-750	FAAH inhibitor
PF-3845	FAAH inhibitor
PI-103	PI3K inhibitor|MTOR inhibitor
PIK-90	PI3K inhibitor
PJ-34	PARP inhibitor
PKCbeta-inhibitor	PKC inhibitor
vemurafenib	RAF inhibitor
PNU-74654	Beta-catenin inhibitor
PP-30	RAF inhibitor
prima-1-met	Thioredoxin inhibitor
PRL-3-inhibitor-I	Tyrosine phosphatase inhibitor
PT-630	Dipeptidyl peptidase inhibitor
PTB1	AMPK activator
PX-12	Thioredoxin inhibitor
parbendazole	Tubulin inhibitor
phenothiazine	Dopamine receptor antagonist
promethazine	Histamine receptor antagonist
QS-11	ARFGAP inhibitor
quinine	Hemozoin biocrystallization inhibitor
fostamatinib	SYK inhibitor
RG-108	DNA methyltransferase inhibitor
RHO-kinase-inhibitor-III[rockout]	Rho associated kinase inhibitor
Ro-28-1675	Glucokinase activator
SB-216763	Glycogen synthase kinase inhibitor
SID-26681509	Cathepsin inhibitor
SRT-1720	SIRT activator
STAT3-inhibitor-VI	STAT inhibitor
SU-11652	Tyrosine kinase inhibitor
orantinib	PDGFR tyrosine kinase receptor inhibitor|FGFR inhibitor|VEGFR inhibitor
salermide	SIRT inhibitor
TG-101348	JAK inhibitor|FLT3 inhibitor
TGX-115	PI3K inhibitor
TPCA-1	IKK inhibitor
TW-37	BCL inhibitor
temozolomide	DNA alkylating drug
tipifarnib	Farnesyltransferase inhibitor
tipifarnib-P2	Farnesyltransferase inhibitor
cyanoquinoline-11	Kinase inhibitor
triacsin-c	Adrenergic receptor antagonist
UK-356618	Metalloproteinase inhibitor
UNC-0321	Histone lysine methyltransferase inhibitor
ursolic-acid	11-beta hydroxysteroid dehydrogenase inhibitor|Acetylcholinesterase inhibitor|Caspase inhibitor|HIV protease inhibitor|Lipid peroxidase inhibitor|Quorum sensing signaling modulator|Steryl sulfatase inhibitor|Tyrosine phosphatase inhibitor|ATPase inhibitor|NFkB pathway inhibitor|STAT inhibitor
VER-155008	HSP inhibitor
tozasertib	Aurora kinase inhibitor|Bcr-Abl kinase inhibitor|FLT3 inhibitor|JAK inhibitor
valdecoxib	Cyclooxygenase inhibitor
YK-4279	Apoptosis stimulant|Binding of RNA helicase A to the transcription factor EWS-FLI1 inhibitor
YM-155	Survivin inhibitor
ZM-336372	RAF inhibitor
artesunate	DNA synthesis inhibitor
atorvastatin	HMGCR inhibitor
auranofin	NFkB pathway inhibitor
blebbistatin	ATPase inhibitor
chaetocin	Histone lysine methyltransferase inhibitor
darinaparsin	Apoptosis stimulant
elesclomol	Oxidative stress inducer
endo-IWR-1	PARP inhibitor
erastin	Ion channel antagonist
gemcitabine	Ribonucleotide reductase inhibitor
myriocin	Serine palmitoyltransferase inhibitor
phorbol-12-myristate-13-acetate	PKC activator
zebularine	DNA methyltransferase inhibitor
temsirolimus	MTOR inhibitor
thiazolopyrimidine	CDC inhibitor
LDN-193189	Serine/threonine kinase inhibitor
BRD-K91691979	Glucosylceramidase inhibitor
BRD-K76425766	Metalloproteinase inhibitor
BRD-K19059335	Runt-related transcription factor inhibitor
BRD-K14609189	PPAR receptor agonist
benzbromarone	Chloride channel blocker
BRD-A28422330	CDC inhibitor
BRD-A12633378	Potassium channel activator
BRD-K77690805	Pyruvate kinase isozyme activator
BRD-K58033748	Acetylcholine receptor antagonist
BRD-K45031696	Cytohesin inhibitor
BRD-K27074404	Solute carrier family member inhibitor
BRD-A16820783	Phosphodiesterase inhibitor
BRD-K00313977	APEX inhibitor
BRD-K07872006	Lipoxygenase inhibitor
EMF-BCA1-64	Caspase inhibitor
BRD-K11757396	Neuropeptide receptor ligand
BRD-K12401458	Lysophospholipid receptor agonist
BRD-K14048378	Lysophospholipid receptor agonist
BRD-K14236372	Lysophospholipid receptor agonist
BRD-K16618170	Lysophospholipid receptor agonist
BRD-K24127443	Lipoxygenase inhibitor
BRD-K35133769	Lipoxygenase inhibitor
BRD-K36038115	Neuropeptide receptor antagonist
KU-C103871	GSP agonist
BRD-K60218670	Lipoxygenase inhibitor
BRD-K64314806	Lipoxygenase inhibitor
EMF-BCA1-57	Caspase inhibitor
EMF-BCA1-60	Caspase inhibitor
FR-180204	MAP kinase inhibitor
BRD-K72817452	Lipoxygenase inhibitor
BRD-K73285375	Lipoxygenase inhibitor
10H-phenothiazin-10-yl)(p-tolyl)methanone	Butyrylcholinesterase inhibitor
2-(biphenyl-4-ylsulfonamido)pentanedioic-acid	Matrix metalloprotease inhibitor
BRD-K73709114	Glucosylceramidase inhibitor
BRD-K77681376	Casein kinase inhibitor
mafenide	Carbonic anhydrase inhibitor
BRD-K76211160	Cytochrome P450 inhibitor
5-nonyloxytryptamine	Serotonin receptor agonist
azathioprine	Dehydrogenase inhibitor
CAM-9-026	Membrane metalloendopeptidase inhibitor
KU-C103428N	CDC inhibitor|Rho associated kinase inhibitor
KU-C103443N	CDC inhibitor|Rho associated kinase inhibitor
KU-C103885	Cystic fibrosis transmembrane conductance regulator inhibitor
BRD-A53107311	Mitotic kinesin inhibitor
BRD-K48974000	CDC inhibitor
BRD-A69470004	XIAP inhibitor
BRD-A05680309	Caspase activator|XIAP inhibitor
BRD-A97035593	XIAP inhibitor
BRD-K55186349	Apelin receptor antagonist
myricetin	Androgen receptor agonist|Cytochrome P450 inhibitor
BRD-K53780220	FLT3 inhibitor
BRD-K56658166	Calcium channel blocker|Sodium channel blocker
BRD-K28452084	Opioid receptor agonist
BRD-K97274161	Beta-catenin inhibitor
BRD-K20401833	ROR inverse agonist
BRD-K70693222	DYRK inhibitor
latrepirdine	Glutamate receptor antagonist
BRD-K73610817	Apoptosis inhibitor
BRD-K78883024	Neuropeptide receptor antagonist
BRD-K30351863	APEX inhibitor
BRD-K37940862	Neuropeptide receptor antagonist
BRD-K68783079	CLK inhibitor|DYRK inhibitor
BRD-K59222562	DYRK inhibitor
BRD-K88761633	Glucosylceramidase inhibitor
BRD-A18279961	Pyruvate kinase isozyme activator
BRD-K06956503	Glucosylceramidase inhibitor
BRD-A32917072	ROR antagonist
BRD-A61599461	Thyroid-stimulating hormone receptor inverse agonist
BRD-A81377415	DYRK inhibitor|CLK inhibitor
BRD-A38793261	ROR antagonist
SAL-1	Adenosine receptor antagonist
BRD-A41630653	Glutamate receptor antagonist
VU-0365114-2	M5 modulator
VU-0366037-2	Glutamate receptor modulator
VU-0400071-3	Glutamate receptor modulator
VU-0400193-3	Glutamate receptor modulator
VU-0400195-3	Glutamate receptor modulator
VU-0404997-2	Glutamate receptor modulator
VU-0413807-2	Calcium channel blocker
VU-0415374-1	Glutamate receptor modulator
VU-0418946-1	HIF modulator
VU-0418947-2	HIF modulator
VU-0420363-1	SARS coronavirus 3C-like protease inhibitor
acyclovir	DNA polymerase inhibitor
azithromycin	Bacterial 50S ribosomal subunit inhibitor
BIX-02188	MEK inhibitor
carbidopa	Aromatic L-amino acid decarboxylase inhibitor
cefotaxime	Bacterial cell wall synthesis inhibitor
clopidogrel	Purinergic receptor antagonist
dicloxacillin	Bacterial cell wall synthesis inhibitor
ethambutol	Bacterial cell wall synthesis inhibitor
gatifloxacin	Bacterial DNA gyrase inhibitor
glycopyrrolate	Acetylcholine receptor antagonist
propranolol	Adrenergic receptor antagonist
lamivudine	Nucleoside reverse transcriptase inhibitor
methylprednisolone	Glucocorticoid receptor agonist
penicillin	Bacterial cell wall synthesis inhibitor
phenelzine	Monoamine oxidase inhibitor
ribavirin	Antiviral
rifapentine	RNA polymerase inhibitor
terazosin	Adrenergic receptor antagonist
dextrorphan	Glutamate receptor antagonist
cotinine	Nicotine metabolite
BRD-A17664363	Steroidogenic factor antagonist
BRD-A54632525	Lipoxygenase inhibitor
BRD-A61189834	XIAP inhibitor
BRD-A89049230	Thyroid hormone stimulant
BRD-A93048969	Acetylcholine receptor antagonist
BRD-A94297859	XIAP inhibitor
BRD-K00256256	Protein phosphatase inhibitor
BRD-K01265221	BCL inhibitor
BRD-K06217810	DYRK inhibitor
pyroxamide	HDAC inhibitor
givinostat	HDAC inhibitor
BRD-K19985802	Protein phosphatase inhibitor
BRD-K21009077	Dual specificity protein phosphatase inhibitors
ALW-II-49-7	Ephrin inhibitor
TUL-XXI039	Serine/threonine kinase inhibitor
BIX-01294	DNA methyltransferase inhibitor|Histone lysine methyltransferase inhibitor
cyproheptadine	Histamine receptor antagonist
ketoconazole	Sterol demethylase inhibitor
BRD-K32656671	Mannose-6-phosphate isomerate inhibitor
cytarabine	Ribonucleotide reductase inhibitor
diphenhydramine	Histamine receptor antagonist
2-(4-methoxybenzylthio)-6-methylpyrimidin-4-ol	Matrix metalloprotease inhibitor
BRD-K48969316	Caspase inhibitor
nandrolone	Imidazoline receptor agonist
BRD-K61106942	Pyruvate kinase isozyme activator
N-(3-acetamidophenyl)-3-chlorobenzamide	Glutamate receptor antagonist
apicidin	HDAC inhibitor
ML-167	CLK inhibitor|DYRK inhibitor
ALW-II-38-3	Ephrin inhibitor
BRD-K70751730	Histone lysine demethylase inhibitor
QW-BI-011	Histone lysine methyltransferase inhibitor
WT-171	HDAC inhibitor
entinostat	HDAC inhibitor
BRD-K85853281	Topoisomerase inhibitor
selegiline	Monoamine oxidase inhibitor
BRD-K87426499	Caspase inhibitor
nicorandil	Nitric oxide donor|Potassium channel activator
HG-6-64-01	RAF inhibitor
HG-5-88-01	Protein kinase inhibitor
JW-7-24-1	LCK Inhibitor
HG-5-113-01	Protein kinase inhibitor
BRD-K26947839	NADPH inhibitor
secnidazole	Acetylcholinesterase inhibitor|Microtubule inhibitor
1-benzylimidazole	Thromboxane synthase inhibitor
NM-PP1	Mutant kinase inhibitor
HU-211	Glutamate receptor antagonist
CAY-10470	NFkB pathway inhibitor
propylpyrazole	Estrogen receptor agonist
CAY-10578	Casein kinase inhibitor
treprostinil	Prostacyclin analog
larixinic-acid	Compund that interacts with metal centers
CP-466722	ATM kinase inhibitor
ipidacrine	Acetylcholinesterase inhibitor
BRD-K55055802	Membrane integrity inhibitor|Membrane permeability inhibitor
BRD-K20168484	Lipoxygenase inhibitor
zalcitabine	Nucleoside reverse transcriptase inhibitor
didanosine	Nucleoside reverse transcriptase inhibitor
niacin	NAD precursor with lipid lowering effects|Vitamin B
cladribine	Adenosine deaminase inhibitor|Ribonucleoside reductase inhibitor
BRD-K79511609	Adenosine receptor agonist
iloprost	Platelet aggregation inhibitor|Prostanoid receptor agonist
LM-1685	Cyclooxygenase inhibitor
BRD-K57954781	Apoptosis stimulant
deferiprone	Chelating agent
PD-173074	FGFR inhibitor|VEGFR inhibitor
GANT-61	GLI antagonist
moclobemide	Monoamine oxidase inhibitor
thiazolidinecarboxylic-acid	Reducing agent
mesalazine	Cyclooxygenase inhibitor|Lipoxygenase inhibitor|Prostanoid receptor antagonist
5-FP	Thymidylate synthase inhibitor
flucytosine	Other antifungal
5-methoxytryptamine	Serotonin receptor agonist
epigallocatechin-gallate-(-)	Bacterial DNA gyrase inhibitor
mofezolac	Cyclooxygenase inhibitor
aminoindazole	Ionophore
azauridine	Antiviral
fludarabine	DNA synthesis inhibitor
AF-DX-116	Acetylcholine receptor antagonist
CAY-10415	Insulin sensitizer
BRD-K15107389	Ribosomal protein inhibitor
nikkomycin	Chitinase inhibitor
BRD-K63954456	TNF production inhibitor
MW-STK33-3B	Potassium channel activator
BRD-A07614565	Botulin neurotoxin inhibitor
desloratadine	Histamine receptor antagonist
tacrine	Acetylcholinesterase inhibitor
decitabine	DNA methyltransferase inhibitor
6-aminochrysene	Transferase inhibitor
antimycin-a	ATP synthase inhibitor
BIX-01338	Histone lysine methyltransferase inhibitor
BAS-09104376	HIV integrase inhibitor
buthionine-sulfoximine	Glutathione transferase inhibitor
cytochalasin-d	Actin polymerization inhibitor
doxercalciferol	Vitamin D receptor agonist
depudecin	HDAC inhibitor
ebselen	Cyclooxygenase inhibitor|Glutathione peroxidase agonist|H+/K+-ATPase inhibitor|Nitric oxide synthase inhibitor
alvocidib	CDK inhibitor
carbetocin	Oxytocin receptor agonist
dasatinib	KIT inhibitor|Src inhibitor|Bcr-Abl kinase inhibitor|Ephrin inhibitor|PDGFR tyrosine kinase receptor inhibitor|Tyrosine kinase inhibitor
NVP-TAE684	ALK tyrosine kinase receptor inhibitor
AZD-7762	CHK inhibitor
GSK-429286A	Rho associated kinase inhibitor
GNF-2	Bcr-Abl kinase inhibitor
CP-724714	Tyrosine kinase inhibitor|EGFR inhibitor
CGP-60474	CDK inhibitor
GSK-461364	PLK inhibitor
AT-7519	CDK inhibitor|Cell cycle inhibitor
imatinib	PDGFR tyrosine kinase receptor inhibitor|Bcr-Abl kinase inhibitor|KIT inhibitor
latrunculin-b	Actin polymerization inhibitor|Unidentified pharmacological activity
BRD-K54331210	Alkaline phosphatase inhibitor
BRD-K71427192	XIAP inhibitor
BRD-K91485395	Dual specificity protein phosphatase inhibitors
heraclenol	Vitamin K antagonist
BRD-K52640952	Topoisomerase inhibitor
BRD-K97951054	Aurora kinase inhibitor|PIM kinase inhibitor|VEGFR inhibitor
OM-137	Aurora kinase inhibitor
PD-168077	Dopamine receptor agonist
varenicline	Acetylcholine receptor agonist
linezolid	Bacterial 50S ribosomal subunit inhibitor
parthenolide-(alternate-stereo)	NFkB pathway inhibitor
alitretinoin	Retinoid receptor agonist
sorafenib	RAF inhibitor|FLT3 inhibitor|KIT inhibitor|PDGFR tyrosine kinase receptor inhibitor|RET tyrosine kinase inhibitor|VEGFR inhibitor
axitinib	VEGFR inhibitor|PDGFR tyrosine kinase receptor inhibitor
saracatinib	Src inhibitor
afatinib	EGFR inhibitor
PD-184352	MEK inhibitor
deforolimus	MTOR inhibitor
lapatinib	EGFR inhibitor|ErbB2 inhibitor
panobinostat	HDAC inhibitor
motesanib	KIT inhibitor|PDGFR tyrosine kinase receptor inhibitor|VEGFR inhibitor
PD-0325901	MEK inhibitor|MAP kinase inhibitor|Protein kinase inhibitor
tandutinib	FLT3 inhibitor|KIT inhibitor|PDGFR tyrosine kinase receptor inhibitor
obatoclax	BCL inhibitor
HA-14-1	BCL inhibitor
ZSTK-474	PI3K inhibitor
belinostat	HDAC inhibitor
GSK-1904529A	IGF-1 inhibitor|Insulin growth factor receptor inhibitor|Insulin receptor ligand
ZM-447439	Aurora kinase inhibitor
danusertib	Aurora kinase inhibitor|Growth factor receptor inhibitor
andarine	Androgen receptor modulator
barasertib-HQPA	Aurora kinase inhibitor
docetaxel	Tubulin inhibitor
PLX-4720	RAF inhibitor
SNS-314	Aurora kinase inhibitor
capecitabine	DNA synthesis inhibitor|Thymidylate synthase inhibitor
enobosarm	Androgen receptor modulator
BIIB-021	HSP inhibitor
raltitrexed	Thymidylate synthase inhibitor
JNJ-7706621	CDK inhibitor
epothilone-a	Microtubule stabilizing agent
floxuridine	DNA synthesis inhibitor
KI-16425	Lysophosphatidic acid receptor antagonist
ON-01910	PLK inhibitor
epothilone	Microtubule inhibitor
amonafide	Topoisomerase inhibitor
ispinesib	Kinesin inhibitor
cilomilast	Phosphodiesterase inhibitor
zibotentan	Endothelin receptor antagonist
raltegravir	HIV integrase inhibitor
sitagliptin	Dipeptidyl peptidase inhibitor
tofacitinib	JAK inhibitor
topotecan	Topoisomerase inhibitor
tunicamycin	GLCNAC phosphotransferase inhibitor
thiostrepton	FOXM1 inhibitor|Protein synthesis inhibitor
acarbose	Glucosidase inhibitor
actarit	Interleukin receptor agonist
BRD-A73929928	Adenosine receptor agonist
alosetron	Serotonin receptor antagonist
alprazolam	Benzodiazepine receptor agonist
amlexanox	Histamine receptor modulator
ampiroxicam	Cyclooxygenase inhibitor
anastrozole	Aromatase inhibitor
argatroban	Thrombin inhibitor
aripiprazole	Serotonin receptor agonist|Serotonin receptor antagonist
artemether	Antimalarial agent
atracurium	Acetylcholine receptor antagonist
azelastine	Histamine receptor antagonist
balsalazide	Cyclooxygenase inhibitor
beclometasone	Glucocorticoid receptor agonist
benactyzine	Acetylcholine receptor antagonist
benidipine	Calcium channel blocker
benproperine	Antitussive
bifonazole	Sterol demethylase inhibitor
buflomedil	Adrenergic receptor antagonist|Calcium channel blocker
carmofur	Thymidylate synthase inhibitor
cefaclor	Bacterial cell wall synthesis inhibitor
cefatrizine	Bacterial cell wall synthesis inhibitor
cefdinir	Bacterial cell wall synthesis inhibitor
cefpodoxime	Bacterial cell wall synthesis inhibitor
cephalexin	Bacterial cell wall synthesis inhibitor
cerivastatin	HMGCR inhibitor
cetraxate	Mucus protecting agent
chlordiazepoxide	Benzodiazepine receptor agonist
clarithromycin	Bacterial 50S ribosomal subunit inhibitor
clofazimine	GK0582 inhibitor
clotrimazole	Cytochrome P450 inhibitor|Imidazoline ligand
corticosterone	Mineralocorticoid receptor agonist
cycloserine-(d)	Bacterial cell wall synthesis inhibitor
dehydrocholic-acid	Bile acid
dexbrompheniramine	Histamine receptor antagonist
dexchlorpheniramine	Histamine receptor antagonist
dichloroacetic-acid	Pyruvate dehydrogenase kinase inhibitor
diphenoxylate	Opioid receptor agonist
diphencyprone	Immunostimulant
dofetilide	Potassium channel blocker
dolasetron	Serotonin receptor antagonist
doxapram	Potassium channel blocker
efavirenz	HIV protease inhibitor
enalaprilat	Angiotensin converting enzyme inhibitor
esmolol	Adrenergic receptor antagonist
esomeprazole	ATPase inhibitor
BRD-K47448802	Acetylcholine receptor agonist
ethylestrenol	Progesterone receptor agonist
ethinylestradiol	Estrogen receptor agonist
famotidine	Histamine receptor antagonist
fenpiverinium	Acetylcholine receptor antagonist
flubendazole	Tubulin inhibitor
flurbiprofen-(+/-)	Cyclooxygenase inhibitor
tegafur	Thymidylate synthase inhibitor
goserelin	Luteinizing hormone releasing hormone agonist
granisetron	Serotonin receptor antagonist
halometasone	Glucocorticoid receptor agonist
homoveratrylamine	Dopamine analog
honokiol	AKT inhibitor
hyperoside	Glucosidase inhibitor
idebenone	Calcium channel modulator
ifenprodil	Adrenergic receptor antagonist|Glutamate receptor antagonist
indatraline	Norepinephrine transporter inhibitor
indinavir	HIV protease inhibitor
ipriflavone	Bone resorption inhibitor
isoquercetin	Aldose reductase inhibitor
pitavastatin	HMGCR inhibitor
itopride	Dopamine receptor antagonist
kitasamycin	Protein synthesis inhibitor
methotrexate	Dihydrofolate reductase inhibitor
targinine	Nitric oxide synthase inhibitor
lacidipine	Calcium channel blocker
lansoprazole	ATPase inhibitor
latanoprost	Prostanoid receptor agonist
levetiracetam	Calcium channel blocker
levocetirizine	Histamine receptor antagonist
levofloxacin	Bacterial DNA gyrase inhibitor
levosulpiride	Dopamine receptor antagonist
lobeline	Acetylcholine receptor antagonist
lofepramine	Norepinephrine reuptake inhibitor|Serotonin reuptake inhibitor
lofexidine	Adrenergic receptor agonist
lomerizine	Calcium channel blocker
loratadine	Histamine receptor antagonist
lorazepam	Benzodiazepine receptor agonist
loteprednol	Glucocorticoid receptor agonist|Phospholipase inhibitor
loxoprofen	Cyclooxygenase inhibitor|Prostanoid receptor antagonist
mecillinam	Bacterial cell wall synthesis inhibitor
medroxyprogesterone	Progesterone receptor agonist
memantine	Glutamate receptor antagonist
mepivacaine	Potassium channel blocker|Sodium channel blocker
meropenem	Bacterial cell wall synthesis inhibitor
mestanolone	Androgenic steroid
methandriol	Androgenic steroid
metronidazole	DNA inhibitor
midazolam	Benzodiazepine receptor agonist
miglitol	Glucosidase inhibitor
milnacipran	Serotonin reuptake inhibitor
montelukast	Leukotriene receptor antagonist
mosapride	Serotonin receptor agonist
moxifloxacin	Bacterial DNA gyrase inhibitor
hexamethylenebisacetamide	AKT inhibitor|Differentiation inducer|NFKB pathway inhibitor
naftopidil	Adrenergic receptor antagonist
nelfinavir	HIV protease inhibitor
nialamide	Monoamine oxidase inhibitor
nicotinamide	Protein synthesis stimulant
nifekalant	Potassium channel blocker
nimetazepam	GABA receptor agonist
nisoldipine	Calcium channel blocker
nitazoxanide	Pyruvate ferredoxin oxidoreductase inhibitor
nitrazepam	Benzodiazepine receptor agonist
nornicotine	Acetylcholine receptor agonist
olanzapine	Dopamine receptor antagonist|Serotonin receptor antagonist
oligomycin-c	ATP synthase inhibitor|ATPase inhibitor
olmesartan	Angiotensin receptor antagonist
olopatadine	Histamine receptor antagonist
orlistat	Lipase inhibitor
ormetoprim	Bacterial antifolate
oxiconazole	Bacterial cell wall synthesis inhibitor
oxymetholone	Androgen receptor agonist
oxyphenonium	Cholinergic receptor antagonist
palonosetron	Serotonin receptor antagonist
pancuronium	Acetylcholine receptor antagonist
parecoxib	Cyclooxygenase inhibitor
pazufloxacin	Topoisomerase inhibitor
pefloxacin	Bacterial DNA gyrase inhibitor
pemoline	Dopamine receptor agonist
penciclovir	DNA directed DNA polymerase inhibitor
perospirone	Dopamine receptor antagonist|Serotonin receptor antagonist
phenprobamate	Muscle relaxant
polydatin	ICAM1 expression inhibitor
pidotimod	Interferon receptor agonist|Interleukin receptor agonist
pilocarpine	Acetylcholine receptor agonist
pramipexole	Dopamine receptor agonist
pterostilbene	Cyclooxygenase inhibitor|PPAR receptor agonist
rabeprazole	ATPase inhibitor|Gastrin inhibitor
reichstein	Androgen receptor antagonist
rifabutin	Protein synthesis inhibitor
rifaximin	RNA synthesis inhibitor
ritonavir	HIV protease inhibitor
rolitetracycline	Bacterial 30S ribosomal subunit inhibitor
ropivacaine	Sodium channel blocker
roxatidine-acetate	Histamine receptor antagonist
rufloxacin	Bacterial DNA gyrase inhibitor
salbutamol	Adrenergic receptor agonist
secoisolariciresinol	Antioxidant
sibutramine	Serotonin reuptake inhibitor
stavudine	DNA directed DNA polymerase inhibitor|Reverse transcriptase inhibitor
stiripentol	GABA uptake inhibitor
sulfasalazine	Antirheumatic drug|NFkB pathway inhibitor
sumatriptan	Serotonin receptor agonist
synephrine	Adrenergic receptor agonist
taxifolin	Opioid receptor antagonist
tegaserod	Serotonin receptor partial agonist
terbinafine	Fungal squalene epoxidase inhibitor
disulfiram	Aldehyde dehydrogenase inhibitor|DNA methyltransferase inhibitor|TRPV agonist
TFMPP	Serotonin receptor agonist|Serotonin receptor antagonist
tiagabine	GABA uptake inhibitor
tibolone	Estrogen receptor agonist|Androgen receptor agonist|Progesterone receptor agonist
tinidazole	Antiprotozoal agent
tolterodine	Acetylcholine receptor antagonist
topiramate	Carbonic anhydrase inhibitor|Glutamate receptor antagonist|Kainate receptor antagonist
tosufloxacin	Bacterial DNA gyrase inhibitor
tremulacin	Lipoxygenase inhibitor
triclabendazole	Microtubule inhibitor
oxcarbazepine	Sodium channel blocker
trimebutine	Opioid receptor agonist
troxipide	Glucosamine synthetase stimulant
urapidil	Adrenergic receptor antagonist
valaciclovir	DNA polymerase inhibitor
vecuronium	Acetylcholine receptor antagonist
vindesine	Tubulin inhibitor
vinorelbine	Tubulin inhibitor
nevirapine	Reverse transcriptase inhibitor
voriconazole	Cytochrome P450 inhibitor
xanthinol	Vasodilator
zafirlukast	Leukotriene receptor antagonist
zeranol	Estrogen receptor agonist
zolpidem	Benzodiazepine receptor agonist
AS-601245	JNK inhibitor
XMD-1150	Leucine rich repeat kinase inhibitor
KIN001-244	Phosphoinositide dependent kinase inhibitor
JNK-9L	JNK inhibitor
KIN001-242	Protein kinase inhibitor
A-443644	AKT inhibitor
torin-1	MTOR inhibitor|PI3K inhibitor
XMD-892	MAP kinase inhibitor
GDC-0941	PI3K inhibitor
dacinostat	HDAC inhibitor
XMD-885	Leucine rich repeat kinase inhibitor|MAP kinase inhibitor
torin-2	MTOR inhibitor
WZ-4002	EGFR inhibitor
JWE-035	Aurora kinase inhibitor
CG-930	JNK inhibitor
WZ-3105	CLK2 inihibitor
XMD-1499	EPHB3 inhibitor
WZ-4-145	EGFR inhibitor
WZ-7043	CSF1R inhibitor
QL-X-138	MTOR inhibitor
WH-4023	Src inhibitor
ZG-10	JNK inhibitor
QL-XI-92	DDR1 inhibitor
THZ-2-98-01	IRAK1 inhibitor
QL-XII-47	BTK inhibitor|Cytoplasmic tyrosine protein kinase BMX inhibitor
somatostatin	Somatostatin receptor agonist
AS-604850	PI3K inhibitor
CAY-10577	Casein kinase inhibitor
CAY-10585	HIF modulator
neurodazine	Neurogenesis of non-pluripotent C2C12 myoblast inducer
HNHA	HDAC inhibitor
oxalomalic-acid	Isocitrate dehydrogenase inhibitor
chromomycin-a3	DNA binding agent
calmidazolium	Calcium channel blocker|Calmodulin antagonist
GSK-3-inhibitor-IX	Glycogen synthase kinase inhibitor|Lipoxygenase inhibitor
celastrol	Anti-inflammatory agent|Antioxidant|HSP inhibitor|NFkB pathway inhibitor|Topoisomerase inhibitor
ochratoxin-a	Phenylalanyl tRNA synthetase inhibitor
KU-55933	ATM kinase inhibitor
GW-501516	PPAR receptor agonist|Insulin sensitizer
tenovin-1	SIRT inhibitor|TP53 activator
7,8-dihydro-L-biopterin	Dihydroneopterin aldolase inhibitor
OSI-027	MTOR inhibitor
APHA-compound-8	HDAC inhibitor
tyrphostin-AG-1295	PDGFR tyrosine kinase receptor inhibitor
BI-78D3	JNK inhibitor
BCI-hydrochloride	Protein phosphatase inhibitor
retinol	Retinoid receptor ligand
retinyl-acetate	Vitamin analog
cholic-acid	Bile acid
deoxycholic-acid	G protein coupled receptor agonist|Unidentified pharmacological activity|Biliverdin reductase A activator|G protein-coupled receptor agonist
chenodeoxycholic-acid	11-beta-HSD1 inhibitor|FXR agonist
taurocholic-acid	Bile acid
taurodeoxycholic-acid	Bile acid
TCPOBOP	CAR agonist
lithocholic-acid	MDM inhibitor|PXR ligand|Tyrosine phosphatase inhibitor|Vitamin D receptor ligand|FXR antagonist|Vitamin D receptor agonist
farnesol	FXR agonist|Monoamine oxidase B inhibitor|NFkB pathway activator|PPAR receptor agonist
androstenol	GABA receptor modulator
androstanol	CAR antagonist
androstenedione	Cytochrome P450 inhibitor
D-609	Phospholipase inhibitor
cyclazosin	Adrenergic receptor antagonist
2-aminopurine	Serine/threonine kinase inhibitor
ruxolitinib	JAK inhibitor
CGP-52411	EGFR inhibitor
calcifediol	Vitamin D receptor agonist
ebelactone-b	Lipase inhibitor
ellipticine	Topoisomerase inhibitor
H-7	PKA inhibitor
sphingosine	Ceramidase inhibitor
staurosporine	PKC inhibitor
tyrphostin-51	EGFR inhibitor
tyrphostin-A9	Protein tyrosine kinase inhibitor|Tyrosine kinase inhibitor
dexketoprofen	Cyclooxygenase inhibitor
EI-231	Casein kinase inhibitor
lavendustin-c	EGFR inhibitor
EI-247	IGF-1 inhibitor
tyrphostin-AG-126	ERK1 and ERK2 phosphorylation inhibitor
EI-273	PKC inhibitor
5-iodotubercidin	Adenosine kinase inhibitor
terreic-acid-(-)	Bruton's tyrosine kinase (BTK) inhibitor
tyrphostin-AG-1288	TNF production inhibitor
EI-346-erlotinib-analog	EGFR inhibitor
eicosatetraynoic-acid	Cyclooxygenase inhibitor|Lipoxygenase inhibitor
flupirtine	Glutamate receptor antagonist
acetyl-farnesyl-cysteine	Inhibitor of methylation of endogenous isoprenylated proteins
acetyl-geranygeranyl-cysteine	Inhibitor of methyl esterification of geranylgeranylated proteins
acetyl-geranyl-cysteine	Isoprenylated protein methylation inhibitor
geranylgeraniol	Farnesyltransferase inhibitor
GSK-0660	PPAR receptor antagonist
isotretinoin	Retinoid receptor agonist
acitretin	Retinoid receptor agonist
4-hydroxyretinoic-acid	Retinoid receptor binder
GR-206	Aryl hydrocarbon receptor ligand
3,3'-diindolylmethane	CHK inhibitor|Cytochrome P450 activator|Indoleamine 2,3-dioxygenase inhibitor
hydroxycholesterol	LXR agonist
epoxycholesterol	LXR agonist
GR-235	Estrogen receptor agonist|FXR antagonist|Progesterone receptor agonist
tetradecylthioacetic-acid	Lipid peroxidase inhibitor
hyperforin	Cyclooxygenase inhibitor|Dopamine uptake inhibitor|Interleukin receptor antagonist|Lipoxygenase inhibitor|Serotonin reuptake inhibitor
BRD-K61463582	Aryl hydrocarbon receptor agonist
rifampicin	RNA polymerase inhibitor
HC-toxin	HDAC inhibitor
HO-013	PPAR receptor agonist
WYE-125132	MTOR inhibitor
nilotinib	Bcr-Abl kinase inhibitor|Abl kinase inhibitor
MLN-8054	Aurora kinase inhibitor|Mitotic inhibitor|Protein kinase inhibitor
enzastaurin	PKC inhibitor
AZD-6482	PI3K inhibitor
TAK-715	P38 MAPK inhibitor
PF-562271	Focal adhesion kinase inhibitor
BMS-345541	IKK inhibitor
SB-590885	RAF inhibitor
PHA-793887	CDK inhibitor
AZ-628	RAF inhibitor
BX-912	Pyruvate dehydrogenase kinase inhibitor
NU-7441	P-glycoprotein inhibitor|DNA dependent protein kinase inhibitor
KIN001-127	ITK inhibitor
KIN001-055	EGFR inhibitor|JAK inhibitor|Leukotriene inhibitor|Mediator release inhibitor
quizartinib	FLT3 inhibitor
palbociclib	CDK inhibitor
crizotinib	ALK tyrosine kinase receptor inhibitor
gefitinib	EGFR inhibitor
erlotinib	EGFR inhibitor
GSK-1070916	Aurora kinase inhibitor
aurora-a-inhibitor-i	Aurora kinase inhibitor
K-858	Kinesin-like spindle protein inhibitor
lestaurtinib	FLT3 inhibitor|Growth factor receptor inhibitor|JAK inhibitor
L-2167	PPAR receptor agonist
lopinavir	HIV protease inhibitor
mirin	MRE11A exonuclease inhibitor
BRD-K67258146	Mannose-6-phosphate isomerate inhibitor
PU-H71	HSP inhibitor
prostaglandin	Prostanoid receptor antagonist
pirarubicin	Topoisomerase inhibitor
reversine	Aurora kinase inhibitor
lypressin	Vasopressin receptor agonist
linifanib	PDGFR tyrosine kinase receptor inhibitor|VEGFR inhibitor
bosutinib	Src inhibitor|Abl kinase inhibitor|Bcr-Abl kinase inhibitor
cediranib	VEGFR inhibitor|KIT inhibitor
dovitinib	EGFR inhibitor|FGFR inhibitor|FLT3 inhibitor|PDGFR tyrosine kinase receptor inhibitor|VEGFR inhibitor
canertinib	EGFR inhibitor
pazopanib	VEGFR inhibitor|KIT inhibitor|PDGFR tyrosine kinase receptor inhibitor
sunitinib	FLT3 inhibitor|KIT inhibitor|PDGFR tyrosine kinase receptor inhibitor|RET tyrosine kinase inhibitor|VEGFR inhibitor
masitinib	KIT inhibitor|PDGFR tyrosine kinase receptor inhibitor|Src inhibitor
SU-11274	Hepatocyte growth factor receptor inhibitor|Tyrosine kinase inhibitor
brivanib	FGFR inhibitor|VEGFR inhibitor
GDC-0879	RAF inhibitor
XL-147	PI3K inhibitor
everolimus	MTOR inhibitor
mocetinostat	HDAC inhibitor
TGX-221	PI3K inhibitor
WZ-3146	EGFR inhibitor
JNJ-26481585	HDAC inhibitor
plinabulin	Tubulin inhibitor
danoprevir	HCV inhibitor
aprepitant	Tachykinin antagonist
dexrazoxane	Chelating agent|Topoisomerase inhibitor
entecavir	DNA replication inhibitor|Reverse transcriptase inhibitor
cinacalcet	Calcium channel activator
WYE-354	MTOR inhibitor
VX-745	P38 MAPK inhibitor
safinamide	Dopamine uptake inhibitor|Glutamate inhibitor|Monoamine oxidase inhibitor
AS-703026	MEK inhibitor
VX-222	HCV inhibitor
zosuquidar	P-glycoprotein inhibitor
iloperidone	Dopamine receptor antagonist|Serotonin receptor antagonist
HMN-214	PLK inhibitor
elvitegravir	HIV integrase inhibitor
vicriviroc	CC chemokine receptor antagonist
rivaroxaban	Coagulation factor inhibitor
VX-702	P38 MAPK inhibitor
SB-525334	TGF beta receptor inhibitor
oleoylethanolamide	Cannabinoid receptor agonist|Glucose dependent insulinotropic receptor agonist|Potassium channel blocker|PPAR receptor agonist
tenofovir	Reverse transcriptase inhibitor|HIV integrase inhibitor
teicoplanin	Bacterial cell wall synthesis inhibitor
tamibarotene	Retinoid receptor agonist
verrucarin-a	Protein synthesis inhibitor
xanthohumol	ATPase inhibitor
ziprasidone	Dopamine receptor antagonist|Serotonin receptor antagonist
epinephrine-(racemic)	Carbonic anhydrase activator
norepinephrine	Adrenergic receptor agonist
genipin	Choleretic agent
orciprenaline	Adrenergic receptor agonist
bicuculline	GABA receptor antagonist
cyclophosphamide	DNA alkylating agent
L-ascorbyl-6-palmitate	Antioxidant
4-hydroxy-2-nonenal	Cytotoxic lipid peroxidation product
dihydroxyphenylglycine	Glutamate receptor agonist
streptozotocin	DNA alkylating agent
nomifensine	Dopamine uptake inhibitor|Noradrenaline uptake inhibitor
17-hydroxyprogesterone-caproate	Progesterone receptor agonist
fosinopril	Angiotensin converting enzyme inhibitor
3-methyl-GABA	GABA aminotransferase activator
tetrahydrobiopterin	Nitric oxide stimulant|Nitric oxide synthase stimulant|Phenylalanine 4-hydroxylase stimulant
ascorbic-acid	Antioxidant
cephalosporanic-acid	Bacterial cell wall synthesis inhibitor
4-carboxy-3-hydroxyphenylglycine-(RS)	Glutamate receptor agonist|Glutamate receptor antagonist
1-monopalmitin	P-glycoprotein inhibitor
3-matida	Glutamate receptor antagonist
bimatoprost	Prostanoid receptor agonist
gestrinone	Progesterone receptor antagonist
acadesine	AMPK activator
tubastatin-a	HDAC inhibitor
JNJ-38877605	Tyrosine kinase inhibitor
Merck60	HDAC inhibitor
GSK-1059615	PI3K inhibitor
1,2,3,4,5,6-hexabromocyclohexane	JAK inhibitor
tolcapone	Catechol O methyltransferase inhibitor
aspirin	Cyclooxygenase inhibitor
droxinostat	HDAC inhibitor
trimidox	Ribonucleotide reductase inhibitor
BRD-K13872703	Chloride channel blocker|Purinergic receptor antagonist
4-(2-amino-ethyl)-benzenesulfonamide	Carbonic anhydrase inhibitor
CS-110266	Dopamine receptor agonist
SA-94315	Caspase inhibitor
1-phenylbiguanide	Serotonin receptor agonist
tienilic-acid	Sodium/potassium/chloride transporter inhibitor
edaravone	Nootropic agent
erbstatin-analog	EGFR inhibitor|Tyrosine kinase inhibitor
III606050	Cytochrome P450 inhibitor
acepromazine	Dopamine receptor antagonist
dopamine	Dopamine receptor agonist
methapyrilene	Histamine receptor antagonist
bromfenac	Cyclooxygenase inhibitor
LY-2140023	Glutamate receptor agonist
7,4'-dihydroxyflavone	Opioid receptor antagonist
NCH-51	HDAC inhibitor
abiraterone	Androgen biosynthesis inhibitor
NSC-94258	Anticancer agent
MPEP	Glutamate receptor antagonist
10-hydroxycamptothecin	Topoisomerase inhibitor
heliomycin	ATP synthase inhibitor|Other antibiotic
phenylbutyrate	HDAC inhibitor
eprosartan	Angiotensin receptor antagonist
marbofloxacin	Bacterial DNA gyrase inhibitor
bosentan	Endothelin receptor antagonist
BRD-K75430629	PI3K inhibitor
Ro-3306	CDK inhibitor
metformin	Insulin sensitizer
entacapone	Catechol O methyltransferase inhibitor
iproniazid	Monoamine oxidase inhibitor
dimercaptosuccinic-acid	Chelating agent
PCI-34051	HDAC inhibitor
iodoacetic-acid	Cysteine peptidase inhibitor
cobalt(II)-chloride	HSP inducer
prostratin	PKC activator
BRD-K91781484	NRF2 activator
alfacalcidol	Vitamin D receptor agonist
ataluren	CFTR channel agonist|Dystrophin stimulant
tubacin	HDAC inhibitor
niflumic-acid	Cyclooxygenase inhibitor
BRD-K98824517	Tyrosine phosphatase inhibitor
acamprosate	Glutamate receptor antagonist
17-beta-estradiol	Estrogen receptor agonist
azacitidine	DNA methyltransferase inhibitor
acebutolol	Adrenergic receptor antagonist
vidarabine	Antiviral
5-aminolevulinic-acid	Oxidizing agent
amoxicillin	Penicillin binding protein inhibitor
ampicillin	Bacterial cell wall synthesis inhibitor
atenolol-(+/-)	Adrenergic receptor antagonist
busulfan	DNA inhibitor
captopril	Angiotensin converting enzyme inhibitor
cefazolin	Bacterial cell wall synthesis inhibitor
cefoxitin	Bacterial cell wall synthesis inhibitor
cefuroxime	Bacterial cell wall synthesis inhibitor
chloramphenicol	Bacterial 50S ribosomal subunit inhibitor
benzatropine	Acetylcholine receptor antagonist
cromoglicic-acid	Immunosuppressant
dapsone	Bacterial antifolate
demeclocycline	Bacterial 30S ribosomal subunit inhibitor
depomedrol	Glucocorticoid receptor agonist
phenytoin	Hydantoin antiepileptic
doxazosin	Adrenergic receptor antagonist
doxycycline	Metalloproteinase inhibitor
edrophonium	Acetylcholinesterase inhibitor
rimantadine	Antiviral|RNA synthesis inhibitor
fluocinonide	Glucocorticoid receptor agonist
ganciclovir	DNA polymerase inhibitor
griseofulvin	Tubulin inhibitor
hydroflumethiazide	Sodium/potassium/chloride transporter inhibitor
procyclidine	Acetylcholine receptor antagonist
mefloquine	Adenosine receptor antagonist|Hemoglobin antagonist
mercaptopurine	Immunosuppressant|Protein synthesis inhibitor|Purine antagonist
mesna	Antioxidant
mestinon	Cholinesterase inhibitor
methazolamide	Carbonic anhydrase inhibitor
methimazole	Antithyroid agent
acetylcholine	Acetylcholine receptor agonist
mupirocin	Isoleucyl-tRNA synthetase inhibitor
ofloxacin	Bacterial DNA gyrase inhibitor
oxybutynin	Acetylcholine receptor antagonist
phylloquinone	Gamma carboxylase enzyme|Vitamin K
piperacillin	Bacterial cell wall synthesis inhibitor
prilocaine	Local anesthetic
propantheline	Acetylcholine receptor antagonist
propylthiouracil	Thyroid peroxidase inhibitor
pyrazinamide	Fatty acid synthase inhibitor
pyridine-2-aldoxime	Acetylcholinesterase inhibitor
spectinomycin	Bacterial 30S ribosomal subunit inhibitor
sulfacetamide	PABA antagonist
sulindac	Cyclooxygenase inhibitor
terbutaline	Adrenergic receptor agonist
tetracycline	Bacterial 30S ribosomal subunit inhibitor
theophylline	Adenosine receptor antagonist
tizanidine	Adrenergic receptor agonist
bethanechol	Acetylcholine receptor agonist
westcort	Glucocorticoid receptor agonist
zidovudine	Reverse transcriptase inhibitor
aceclofenac	Prostanoid receptor antagonist
acemetacin	Cyclooxygenase inhibitor
acetazolamide	Carbonic anhydrase inhibitor
acetohexamide	ATP channel blocker
acetylsalicylsalicylic-acid	Cyclooxygenase inhibitor
adenosine-phosphate	Adenosine receptor agonist
adiphenine	Acetylcholine receptor antagonist
allantoin	Product of purine catabolism used in cosmetics
amfepramone	Adrenergic receptor agonist
amikacin	Bacterial 30S ribosomal subunit inhibitor
ampyrone	Cyclooxygenase inhibitor
antazoline	Antihistamine
asenapine	Dopamine receptor antagonist|Serotonin receptor antagonist
astemizole	Histamine receptor antagonist
aztreonam	Bacterial cell wall synthesis inhibitor
baclofen	GABA receptor agonist
bambuterol	Adrenergic receptor agonist
benfluorex	Gluconeogenesis inhibitor
betazole	Histamine receptor agonist
bufexamac	Cyclooxygenase inhibitor
bupivacaine	Sodium channel blocker
pentoxyverine	Sigma receptor agonist
catharanthine	Tubulin inhibitor
chlorhexidine	Membrane integrity inhibitor
chlormezanone	GABA receptor modulator
chlorothiazide	Diuretic
chlorzoxazone	Bacterial 30S ribosomal subunit inhibitor
ciprofloxacin	Bacterial DNA gyrase inhibitor
clemizole	HCV inhibitor
clenbuterol	Adrenergic receptor agonist
clindamycin	Protein synthesis inhibitor
clofilium	Potassium channel blocker
clopamide	Sodium/chloride cotransporter inhibitor
clorgiline	Monoamine oxidase inhibitor
cloxacillin	Bacterial cell wall synthesis inhibitor
colchicine	Microtubule inhibitor
debrisoquine	Norepinephrine inhibitor
dequalinium	PKC inhibitor
cinchocaine	Sodium channel blocker
dihydrostreptomycin	Bacterial 30S ribosomal subunit inhibitor
dimenhydrinate	Histamine receptor antagonist
diperodon	Local anesthetic
dyphylline	Adenosine receptor antagonist|Phosphodiesterase inhibitor
dizocilpine	Glutamate receptor antagonist
dropropizine	Antitussive
dyclonine	Sodium channel blocker
ethosuximide	Succinimide antiepileptic
etofylline	Adenosine receptor antagonist
fadrozole	Aromatase inhibitor
fendiline	Calcium channel blocker
fenspiride	Bronchodilator
fipexide	Psychoactive drug
fludrocortisone	Glucocorticoid receptor agonist|Mineralocorticoid receptor agonist
flumequine	Topoisomerase inhibitor
furosemide	Diuretic
gallamine	Cholinergic receptor antagonist
gentamicin	Bacterial 30S ribosomal subunit inhibitor
glafenine	DeltaF508-CFTR Correctors
guanethidine	Adrenergic inhibitor
hemicholinium-3	Acetylcholine receptor antagonist
heptaminol	Vasoconstrictor
hexamethonium	Cholinergic receptor antagonist
hycanthone	RNA synthesis inhibitor
hydrochlorothiazide	Thiazide diuretic
hydroxyzine	Antihistamine
idoxuridine	DNA directed DNA polymerase inhibitor
isoflupredone	Glucocorticoid receptor agonist
josamycin	Bacterial 50S ribosomal subunit inhibitor
kanamycin	Bacterial 30S ribosomal subunit inhibitor
khellin	Vasodilator
levodopa	Dopamine precursor
lincomycin	Bacterial 30S ribosomal subunit inhibitor
lisinopril	Angiotensin converting enzyme inhibitor
lomefloxacin	Bacterial DNA gyrase inhibitor
lynestrenol	Progestogen hormone
mephenesin	Muscle relaxant
metaraminol	Adrenergic receptor agonist
metitepine	Anti-HCVE2
methyldopa	Adrenergic receptor agonist
meticrane	Diuretic
miconazole	Bacterial cell wall synthesis inhibitor
minocycline	Bacterial 30S ribosomal subunit inhibitor
morantel	Acetylcholine receptor agonist
moroxydine	Antiviral
moxisylyte	Adrenergic receptor antagonist
neomycin	Bacterial 30S ribosomal subunit inhibitor
nifenazone	Analgesic agent
norfloxacin	Bacterial DNA gyrase inhibitor
oxandrolone	Androgen receptor agonist
oxetacaine	Local anesthetic
oxolinic-acid	Bacterial DNA gyrase inhibitor
oxytetracycline	Bacterial 30S ribosomal subunit inhibitor
pentolinium	Cholinergic receptor antagonist
phenylpropanolamine	Adrenergic receptor agonist
pimethixene	Antihistamine
procaine	HMGCR inhibitor
proglumide	CCK receptor antagonist
pyrantel	Nicotinic receptor agonist
apomorphine	Dopamine receptor agonist
sulfadiazine	Bacterial antifolate
sulfaguanidine	Bacterial antifolate
sulfamethoxazole	PABA antagonist
sulfaphenazole	Dihydropteroate synthetase inhibitor
sulfathiazole	Dihydropteroate synthase inhibitor
thiamphenicol	Bacterial 50S ribosomal subunit inhibitor
tioguanine	Purine antagonist
tiapride	Dopamine receptor antagonist
tioconazole	Sterol demethylase inhibitor
tiratricol	Thyroid hormone stimulant
todralazine	Antihypertensive agent
tolfenamic-acid	Cyclooxygenase inhibitor|Prostanoid receptor antagonist|Leukotriene synthesis inhibitor|Prostanoid receptor inhibitor
tolnaftate	Fungal squalene epoxidase inhibitor
tranexamic-acid	Antifibrinolytic|Plasminogen activator inhibitor|Fibrinogen stimulant
metrifonate	Acetylcholinesterase inhibitor
trimethoprim	Dihydrofolate reductase inhibitor
troleandomycin	Protein synthesis inhibitor
xylometazoline	Adrenergic receptor agonist
esatenolol	Adrenergic receptor antagonist
etiocholanolone	GABA receptor modulator
kinetin	Cell division inducer
aceclidine	Acetylcholine receptor agonist
acefylline	Adenosine receptor agonist
acenocoumarol	Vitamin K antagonist
acipimox	Cholesterol inhibitor
alendronic-acid	Bone resorption inhibitor
alizapride	Dopamine receptor antagonist
amifostine	Reducing agent
amphotericin-b	Membrane permeability enhancer
androsterone	Androgen receptor agonist
artemisinin	DNA synthesis inhibitor
atractyloside	Mitochondrial ADP, ATP translocase inhibitor
atropine	Acetylcholine receptor antagonist
avermectin	Anthelmintic agent
bacampicilline	Bacterial cell wall synthesis inhibitor
benfotiamine	Antioxidant
benzethonium	Sodium channel blocker
benzocaine	Sodium channel blocker
betaescin	Interleukin receptor antagonist
bromperidol	Dopamine receptor antagonist
butalbital	GABA receptor antagonist
butamben	Sodium channel blocker
butenafine	Fungal squalene epoxidase inhibitor
butirosin	Bacterial 30S ribosomal subunit inhibitor
butylscopolammonium	Anticholinergic
carbadox	Other antibiotic
carbarsone	Antiprotozoal agent
carbimazole	Antithyroid agent
carisoprodol	Acetylcholine receptor antagonist
cefadroxil	Bacterial cell wall synthesis inhibitor
cefmetazole	Bacterial cell wall synthesis inhibitor
cefotetan	Bacterial cell wall synthesis inhibitor
ceftazidime	Bacterial cell wall synthesis inhibitor
celiprolol	Adrenergic receptor antagonist
cefalotin	Bacterial cell wall synthesis inhibitor
chicago-sky-blue-6b	Glutamate transporter modulator|Macrophage migration inhibiting factor inhibitor|Glutamate inhibitor|Macrophage inhibitor
chlorcyclizine	Histamine receptor antagonist
chlorotrianisene	Estrogenic hormone
chrysenequinone	DNA mismatch binding
ciclopirox	Membrane integrity inhibitor
clobutinol	Antitussive
clodronic-acid	Bone resorption inhibitor
cloperastine	Antitussive
clorsulon	Glycolysis inhibitor
closantel	Chitinase inhibitor|NFkB pathway inhibitor
colistin	Bacterial permeability inducer
cyanocobalamin	Methylmalonyl CoA mutase stimulant|Vitamin B
cyclizine	Histamine receptor modulator
cyclobenzaprine	Adrenergic receptor agonist|Serotonin receptor agonist
dacarbazine	DNA alkylating agent
demecarium	Acetylcholinesterase inhibitor
dexfenfluramine	Serotonin receptor agonist
dicoumarol	NADPH inhibitor
dinoprost	Prostacyclin analog
diosmin	Aryl hydrocarbon receptor agonist|Capillary stabilizing agent
diphenylpyraline	Dopamine uptake inhibitor
metamizole	Cyclooxygenase inhibitor|Opioid receptor agonist
dirithromycin	Bacterial 50S ribosomal subunit inhibitor
doxofylline	Adenosine receptor antagonist
emedastine	Histamine receptor antagonist
epiandrosterone	Steroid
eserine	Cholinesterase inhibitor
etanidazole	Bacterial cell wall synthesis inhibitor
ethionamide	Mycolic synthesis inhibitor
ethoxyquin	Antioxidant
etofenamate	Cyclooxygenase inhibitor
etoricoxib	Cyclooxygenase inhibitor
etretinate	Protein synthesis inhibitor
eucatropine	Acetylcholine receptor antagonist
famprofazone	Cyclooxygenase inhibitor
fenipentol	Choleretic agent
fenoprofen	Prostagladin inhibitor
fentiazac	Cyclooxygenase inhibitor
flumethasone	Glucocorticoid receptor agonist
flunixin	Cyclooxygenase inhibitor
flurandrenolide	Glucocorticoid receptor agonist
folic-acid	Folate receptor ligand
leucovorin	Folate receptor ligand
fomepizole	Alcohol dehydrogenase inhibitor
furaltadone	Bacterial DNA inhibitor
gliclazide	ATP channel blocker|Insulin secretagogue
guanadrel	Adrenergic inhibitor
haloprogin	Other antifungal
hexestrol	Synthetic estrogen
hexetidine	Local anesthetic
hydroxychloroquine	Antimalarial agent
ibandronic-acid	Bone resorption inhibitor
ibutilide	Potassium channel blocker
imipenem	Bacterial cell wall synthesis inhibitor
iohexol	Radiopaque medium
ramifenazone	Cyclooxygenase inhibitor
salsolidine	Monoamine oxidase inhibitor
isosorbide	Nitric oxide stimulant
lanatoside-c	Cardiac glycoside
loracarbef	Bacterial cell wall synthesis inhibitor
mebhydrolin	Antihistamine
meclofenoxate	Nootropic agent
melatonin	Melatonin receptor agonist|Nitric oxide synthase inhibitor
mepenzolate	Acetylcholine receptor antagonist
merbromin	Antiseptic
methoxamine	Adrenergic receptor agonist
mizolastine	Histamine receptor antagonist
monensin	Bacterial permeability inducer
citiolone	Lipotropic|Mucolytic
nadide	Electron acceptor
nalidixic-acid	Bacterial DNA gyrase inhibitor
neostigmine	Acetylcholinesterase inhibitor
nifuroxazide	Bacterial DNA inhibitor
nystatin	Fungal ergosterol inhibitor
opipramol	Sigma receptor agonist
oxacillin	Bacterial cell wall synthesis inhibitor
pempidine	Ganglionic blocker
pentamidine	Anti-pneumocystis agent
phenindione	Vitamin K antagonist
piracetam	Acetylcholine receptor agonist
pramocaine	Local anesthetic
pranlukast	Leukotriene receptor antagonist
pranoprofen	Cyclooxygenase inhibitor
prenylamine	Calcium channel blocker
propidium	DNA intercalating agent
pyridoxine	Vitamin B
rebamipide	Free radical scavenger
ribostamycin	Bacterial 30S ribosomal subunit inhibitor
sertindole	Dopamine receptor antagonist|Serotonin receptor antagonist
sisomicin	Protein synthesis inhibitor
spiramycin	Bacterial 50S ribosomal subunit inhibitor
stanozolol	Androgen receptor agonist
succinylsulfathiazole	Dihydrofolate reductase inhibitor
sulfabenzamide	Bacterial antifolate
sulfachlorpyridazine	Bacterial antifolate
sulfadimethoxine	Protein synthesis inhibitor
sulfamerazine	Bacterial antifolate
sulfadimidine	Bacterial antifolate
sulfamethizole	Bacterial antifolate
sulfamethoxypyridazine	Bacterial antifolate
sulfapyridine	PABA antagonist
sulfaquinoxaline	Vitamin K antagonist
suxibuzone	Cyclooxygenase inhibitor
tazobactam	Beta lactamase inhibitor
tenatoprazole	ATPase inhibitor
tetracaine	Membrane integrity inhibitor
tetraethylenepentamine	Superoxide dismutase inhibitor
thiamine	Vitamin B
thiomersal	Other antibiotic
levothyroxine	Thyroid hormone stimulant
triflusal	Cyclooxygenase inhibitor|Platelet aggregation inhibitor|Thromboxane synthase inhibitor
trihexyphenidyl	Acetylcholine receptor antagonist
trimetazidine	3-ketoacyl CoA thiolase inhibitor
trimethadione	Oxazolidine antiepileptic
trolox	Antioxidant
tylosin	Protein synthesis inhibitor
vancomycin	Bacterial cell wall synthesis inhibitor
vatalanib	KIT inhibitor|PDGFR tyrosine kinase receptor inhibitor|VEGFR inhibitor
vigabatrin	GABA aminotransferase inhibitor
zaleplon	Benzodiazepine receptor agonist
zopiclone	GABA receptor agonist
1,2-propylene-glycol	Organic compound
dioxane	Cytotoxic agent
benzofuran	Carcinogen
nerol	Polyamine biosynthesis inhibitor
fluorouracil	RNA synthesis inhibitor|Thymidylate synthase inhibitor
benzo(e)pyrene	Apoptosis stimulant
CH-223191	Aryl hydrocarbon receptor antagonist
mannitol	Diuretic
DMBA	Carcinogen
emodin	11-beta-HSD1 inhibitor
tryptophan	Serotonin receptor partial agonist
TCDD-dioxin	Aryl hydrocarbon receptor activator
acetaldehyde	Metabolite of ethanol with a role in ethanol addiction
acetamide	Solvent
actinomycin-d	RNA polymerase inhibitor
aflatoxin-b1	Carcinogen
anethole	Glutathione transferase stimulant
benzoic-acid	Precursor for food preservatives, plasticizers and medicinal compounds
bisphenol-a	Synthetic estrogen
cadmium-chloride	Coloring agent
carbaryl	Cholinesterase inhibitor
carbon-tetrachloride	Solvent
kepone	Pesticide
chloroform	Solvent
dichlorodiamine-platinum	Anticancer agent
dieldrin	Enhancer of synaptic activity
dimethylnitrosamine	Carcinogen
fluoxymesterone	Androgen receptor modulator
glycerol	Sugar alcohol
isoniazid	Enoyl-(acyl-carrier protein) reductase Fabl inhibitor
ifosfamide	DNA alkylating agent
melphalan	DNA alkylating agent|DNA inhibitor
methoxychlor	Estrogenic metabolite
methyl-testosterone	Androgen receptor agonist
monocrotaline	Pyrrolizidine alkaloid
pentachlorophenol	ATP channel blocker
silibinin	Cytochrome P450 inhibitor
tetrachloroethylene	Alkaline phosphatase inhibitor
tributyltin	Algicide|Antifouling agent
triphenyl-tin	Algicide|Antifouling agent
urethane	Local anesthetic
zearalenone	Estrogenic metabolite
anthothecol	Antimalarial agent
A-23187	Divalent cation ionophore
syringic-acid	Carbonic anhydrase inhibitor
phorbol-myristate-acetate	PKC activator
BRD-K77634909	HSP inducer|Protein kinase inhibitor
caffeic-acid-phenethyl-ester	NFkB pathway inhibitor|HIV integrase inhibitor
levobunolol	Adrenergic receptor antagonist
levisoprenaline	Adrenergic receptor agonist
octopamine	Trace amine associated receptor agonist
eseroline	Acetylcholinesterase inhibitor
isoprenaline	Adrenergic receptor agonist
atenolol	Adrenergic receptor antagonist
cycloserine	Glutamate receptor agonist
2-aminobenzenesulfonamide	Carbonic anhydrase inhibitor
aminosalicylic-acid	Cyclooxygenase inhibitor
paracetamol	Cyclooxygenase inhibitor
acetylcysteine	Mucolytic agent
adrenosterone	11-beta-HSD1 inhibitor
alcuronium	Muscle relaxant
alexidine	Phosphatidylglycerophosphatase inhibitor
alfadolone	GABA receptor agonist
allopurinol	Xanthine oxidase inhibitor
prostaglandin-e1	Prostanoid receptor antagonist
ambrisentan	Endothelin receptor antagonist
aminocaproic-acid	Plasminogen activator inhibitor
aminohippuric-acid	Renal function diagnostic agent
aminophylline	Adenosine receptor antagonist
amiprilose	CD antagonist
apramycin	Bacterial 30S ribosomal subunit inhibitor
arbutin	Melanin inhibitor
azapropazone	Cyclooxygenase inhibitor
azlocillin	Bacterial cell wall synthesis inhibitor
bacitracin	Bacterial cell wall synthesis inhibitor
benserazide	DOPA decarboxylase inhibitor
benzathine	Bacterial cell wall synthesis inhibitor
bephenium	Acetylcholine receptor agonist
bretylium	Norepinephrine inhibitor
butacaine	Local anesthetic
candesartan	Angiotensin receptor antagonist
canrenone	Mineralocorticoid receptor antagonist
carbachol	Cholinergic receptor agonist
cefepime	Bacterial cell wall synthesis inhibitor
cefsulodin	Bacterial cell wall synthesis inhibitor
chlormadinone	Progesterone receptor agonist
chloropyramine	Histamine receptor antagonist
clavulanic-acid	Lactamase inhibitor
clinafloxacin	Bacterial DNA gyrase inhibitor
clocortolone	Glucocorticoid receptor agonist
cortisol	Glucocorticoid receptor agonist
DAC-004	HDAC activator
DAC-013	HDAC activator
darifenacin	Acetylcholine receptor antagonist
deflazacort	Glucocorticoid receptor agonist
deptropine	Histamine receptor antagonist
diacerein	Interleukin inhibitor
dimaprit	Histamine receptor agonist
dimethadione	Oxazolidine antiepileptic
dorzolamide	Carbonic anhydrase inhibitor
enilconazole	Sterol demethylase inhibitor
enoxacin	Topoisomerase inhibitor
epitiostanol	Androgen receptor agonist
etamsylate	Haemostatic agent
ethaverine	Calcium channel blocker
ethynodiol	Steroidal progestin
etidronic-acid	Bone resorption inhibitor
felbinac	Cyclooxygenase inhibitor
florfenicol	Protein synthesis inhibitor
fosfosal	Phosphodiesterase inhibitor
gabapentin	Calcium channel blocker
Gossypetin	DNA methyltransferase inhibitor
gossypin	Dual specificity protein kinase inhibitor
guaiacol	Local anesthetic
halofantrine	Antimalarial agent
idazoxan	Adrenergic receptor antagonist
imidazolidinyl-urea	Bacterial DNA inhibitor
iodixanol	Radiopaque medium
iopamidol	Radiopaque medium
iopromide	Radiopaque medium
ioversol	Radiopaque medium
isometheptene	Vasoconstrictor
levalbuterol	Adrenergic receptor agonist
levopropoxyphene	Antitussive
lorglumide	CCK receptor antagonist
luteolin	Glucosidase inhibitor
lymecycline	Bacterial 50S ribosomal subunit inhibitor
mecamylamine	Acetylcholine receptor antagonist
meglumine	Excipient
melengestrol	Antineoplastic agent|Steroidal progestin
metacycline	Bacterial 50S ribosomal subunit inhibitor
methenamine	Bacterial DNA inhibitor
methiazole	Anthelmintic agent
methylatropine	Atropine derivative
methyl-dopate	Antihypertensive agent
methyl-hydantoin	Hydantoin antiepileptic
misoprostol	Prostanoid receptor agonist
monobenzone	Melanin inhibitor
morin	Cytochrome P450 inhibitor
latamoxef	Bacterial cell wall synthesis inhibitor
nadifloxacin	Bacterial DNA gyrase inhibitor
nafcilline	Bacterial cell wall synthesis inhibitor
nomegestrol	Progesterone receptor agonist
novobiocin	Bacterial DNA gyrase inhibitor
oxolamine	Antitussive
oxyphenbutazone	Cyclooxygenase inhibitor
paromomycin	Bacterial 30S ribosomal subunit inhibitor
penbutolol	Adrenergic receptor antagonist
pentetic-acid	Chelating agent
phthalylsulfathiazole	Dihydropteroate synthetase inhibitor
pipemidic-acid	Topoisomerase inhibitor
piromidic-acid	Bacterial DNA gyrase inhibitor
pivampicillin	Bacterial cell wall synthesis inhibitor
pralidoxime	Acetylcholinesterase inhibitor
pronetalol	Adrenergic receptor antagonist
pyrithyldione	Psychoactive drug
pyrvinium	Androgen receptor antagonist
rivastigmine	Acetylcholinesterase inhibitor
ronidazole	Antiprotozoal agent
roxarsone	Antiprotozoal agent
roxithromycin	Bacterial 50S ribosomal subunit inhibitor
sarafloxacin	Bacterial DNA gyrase inhibitor
spaglumic-acid	Complement inhibitor|Histamine release inhibitor|Leukotriene receptor antagonist|Membrane permeability enhancer|Glutamate receptor antagonist
sparfloxacin	Bacterial DNA gyrase inhibitor
sulbactam	Beta lactamase inhibitor
sulfadoxine	Dihydropteroate synthase inhibitor
sulfamonomethoxine	Bacterial antifolate
suprofen	Cyclooxygenase inhibitor
gaboxadol	GABA receptor agonist
theobromine	Phosphodiesterase inhibitor
thonzonium	ATPase inhibitor
ticarcillin	Lactamase inhibitor
tiletamine	Glutamate receptor antagonist
trichlormethiazide	Chloride channel blocker
tridihexethyl	Acetylcholine receptor antagonist
trifluridine	DNA directed DNA polymerase inhibitor|Thymidylate synthase inhibitor
tyloxapol	NFkB pathway inhibitor
urosiol	NRF2 activator
viloxazine	Serotonin reuptake inhibitor
viomycin	Protein synthesis inhibitor
xamoterol	Adrenergic receptor agonist
BRD-K80767319	Isocitrate dehydrogenase inhibitor
ACDPP	Glutamate receptor antagonist
BRD-A35769934	Mur transferase inhibitor
BIX-02189	MEK inhibitor
idelalisib	PI3K inhibitor
peruvoside	Cardiac glycoside
BRD-A68202111	ATPase inhibitor
BRD-A84066268	ATPase inhibitor
BRD-K72561299	RNA polymerase inhibitor
cantharidin	Protein phosphatase inhibitor
GSK-650394	Serum/glucocorticoid regulated kinase inhibitor
tacedinaline	HDAC inhibitor
HDAC1-selective	HDAC inhibitor
HDAC3-selective	HDAC inhibitor
benzohydroxamic-acid	Other antifungal
plerixafor	CC chemokine receptor antagonist
NVP-AEW541	IGF-1 inhibitor
tivantinib	Tyrosine kinase inhibitor
AZD-8330	MEK inhibitor
AZD-1480	JAK inhibitor
AZD-5438	CDK inhibitor
amuvatinib	FLT3 inhibitor|KIT inhibitor|PDGFR tyrosine kinase receptor inhibitor|RAD51 inhibitor|RET tyrosine kinase inhibitor
BMS-509744	ITK inhibitor
BMS-777607	AXL kinase inhibitor|C-Met inhibitor|FLT3 inhibitor|Hepatocyte growth factor receptor inhibitor|Macrophage inhibitor|Tyrosine kinase inhibitor
CHIR-99021	Glycogen synthase kinase inhibitor
doramapimod	P38 MAPK inhibitor
foretinib	VEGFR inhibitor
GSK-2126458	PI3K inhibitor|MTOR inhibitor
GSK-690693	AKT inhibitor
trametinib	MEK inhibitor
KIN001-266	MAP kinase inhibitor|TNF production inhibitor
KU-60019	ATM kinase inhibitor
YM-201636	PI3K inhibitor
MGCD-265	VEGFR inhibitor
NVP-BGJ398	FGFR inhibitor
buparlisib	PI3K inhibitor
OSI-930	KIT inhibitor|VEGFR inhibitor
ibrutinib	BTK inhibitor
PF-431396	Focal adhesion kinase inhibitor
PF-477736	CHK inhibitor
pelitinib	EGFR inhibitor
ponatinib	Bcr-Abl kinase inhibitor|FLT3 inhibitor|PDGFR tyrosine kinase receptor inhibitor
SAR-245408	PI3K inhibitor
SAR-245409	PI3K inhibitor
BMS-387032	CDK inhibitor|Cell cycle inhibitor|MCL1 inhibitor
nintedanib	FGFR inhibitor|PDGFR tyrosine kinase receptor inhibitor|VEGFR inhibitor
Y-39983	Rho associated kinase inhibitor
rondual-kinase-inhibitor	Hepatocyte growth factor receptor inhibitor
BG-STK33-03	Serine/threonine kinase inhibitor
methyl-fasudil	Rho associated kinase inhibitor
BG-STK33-59	Serine/threonine kinase inhibitor
BG-STK33-55	Serine/threonine kinase inhibitor
MW-STK33-100	PI3K inhibitor
BRD-K27237442	Dopamine receptor antagonist
5-methoxy-alpha-methyltryptamine	Serotonin reuptake inhibitor
(+/-)-7-hydroxy-2-(N,N-di-n-propylamino)tetralin	Dopamine receptor agonist
norfenfluramine	Serotonin receptor agonist
salsoline	Acetylcholinesterase inhibitor
MK-801	Glutamate receptor antagonist
YM-09151-2	Dopamine receptor antagonist
BRD-K18722736	Opioid receptor antagonist
SK-383933	Dopamine receptor agonist
BRD-K28308851	Histamine receptor agonist
BRD-K67582595	Antiamyloidogenic agent|Dopamine receptor agonist
beta-alanine	Glycine receptor agonist
lactotensin	Neurotensin agonist
alpha-methylserotonin	Serotonin receptor agonist
1,2,3,4-tetrahydroisoquinoline	Secondary amine
bietaserpine	Vesicular monoamine transporter inhibitor
2-aminotetralin	Serotonin reuptake inhibitor
(+)-3-(1-propyl-piperidin-3-yl)-phenol	Dopamine receptor agonist
desmethylclomipramine	Selective serotonin reuptake inhibitor (SSRI)
methoxypyruvic-acid	Insulin secretagogue
5-hydroxytryptophan	Neurotransmitter
oxidopamine	Neurotoxin
6-nitrodopamine	Neurotoxin
6-nitronorepinephrine	Norepinephrine inhibitor
BRD-A05729358	Glutamate receptor antagonist
allantoxanamide	Uricase inhibitor
aminobenztropine	Acetylcholine receptor agonist
chrysamine-g	Beta amyloid inhibitor
ciproxifan	Histamine receptor antagonist
DASB	Serotonin transporter (SERT) ligand
epidepride	Contrast agent|Dopamine receptor ligand
farnesylpyrophosphate	Isoprenoid farnesyl-donor in prenylation reactions
Fluoro-SAHA	HDAC inhibitor
GGTI-2133	GGTase inhibitor
GGTI-297	GGTase inhibitor
GGTI-298	GGTase inhibitor
geranyl-geranyl-pyrophosphate	Intermediate in the HMG-CoA reductase pathway
hydroxytyrosol	HIV integrase inhibitor
IDAM	Serotonin transporter (SERT) ligand
JMV-431	Neurotensin agonist
kaempferol	Bone resorption inhibitor|Estrogen-related receptor inverse agonist
L-744832	Farnesyltransferase inhibitor
LBH-589	HDAC inhibitor
dinorcitalopram-oxalate	Serotonin reuptake inhibitor
n-bromoacetyltryptamine	Melatonin secretion inhibitor
BRD-A52647795	Acetylcholine receptor agonist
methyltyramine	Adrenergic receptor antagonist|Trace amine associated receptor agonist
norcitalopram	Serotonin reuptake inhibitor
BRD-A74767450	Adenosine receptor agonist
NaCl	Essential salt
PD-149163	Neurotensin agonist
RN1	Histone lysine demethylase inhibitor
RTI-55	Dopamine uptake inhibitor
SIB-1508Y	Acetylcholine receptor agonist
SIB-1553A	Acetylcholine receptor agonist
SKF-104078	Adrenergic receptor antagonist
SKF-82958	Dopamine receptor agonist
SKF-83822	Dopamine receptor agonist
SKF-83959	Dopamine receptor antagonist
SR-12813	FXR agonist
rimonabant	Cannabinoid receptor antagonist
SR-144528	Cannabinoid receptor inverse agonist
SR-147778	Cannabinoid receptor antagonist
SR-48692	Neurotensin receptor antagonist
serotonin	Growth factor receptor activator
sirtinol	SIRT inhibitor
suramin	DNA synthesis inhibitor
tropapride	Dopamine receptor antagonist
tyramine	Catecholamine releasing agent
vanillyl-glycol	Plant lignin
WAY-405	Serotonin receptor antagonist
WAY-100635	Serotonin receptor antagonist
nor-1-chlorpromazine	Antipsychotic
nor-1-promazine	Antipsychotic
nor-2-chlorpromazine	Dopamine receptor antagonist
p-aminophenethylspiperone	Dopamine receptor antagonist
trans-bis-q	Acetylcholine receptor agonist
BAY-K8644	Calcium channel activator
BRD-K89912164	Adenylyl cyclase inhibitor
ketocholesterol	HMGCR inhibitor
ABC-294640	Sphingosine kinase inhibitor
Ac-Leu-Leu-Nle-CHO	Proteasome inhibitor
adapalene	Retinoid receptor agonist
aminoresveratrol	Phosphodiesterase inhibitor
anacardic-acid	Glyceraldehyde 3-phosphate dehydrogenase inhibitor
BG-1005	HDAC inhibitor
BG-1013	HDAC inhibitor
BG-1032	HDAC inhibitor
BML-210	HDAC inhibitor
BML-266	SIRT inhibitor
BML-278	SIRT activator
BML-284	WNT agonist
diaminoquinazoline	Anticancer agent
BML-286	WNT signaling inhibitor
bafilomycin	ATPase inhibitor
butyrolactone	Histone acetyltransferase inhibitor
C2-dihydroceramide	Inactive form of C2 ceramide
CTPB	Histone acetyltransferase activator
cardamonin	NFkB pathway inhibitor
carnosol	Antioxidant
dithiothreitol	Reducing agent
diarylsulfonesulfonamide	Frizzled related protein-1 inhibitor
dibutyryl-cAMP-Na	CAMP stimulant
dihydrocapsaicin	TRPV agonist
ellagic-acid	Glutathione transferase inhibitor|Reverse transcriptase inhibitor|Aldose reductase inhibitor|Beta-secretase inhibitor|HCV inhibitor|HIV integrase inhibitor|Quorum sensing signaling modulator
exifone	Nootropic agent
FH-535	PPAR receptor antagonist
foxy-5	WNT5a peptide mimetic
gallic-acid	PPAR receptor agonist|Beta amyloid aggregation inhibitor|Beta amyloid protein neurotoxicity inhibitor|Beta amyloid inhibitor
garcinol	Histone N-acetyltransferase inhibitor
glucosamine	Precursor in the synthesis of glycosylated proteins and lipids
harmine	DYRK inhibitor
hexachlorophene	Potassium channel activator
IM-12	Glycogen synthase kinase inhibitor
IQ1	WNT signaling inhibitor
ITSA-1	HDAC activator
IWP-2	WNT signaling inhibitor
ionomycin	Calcium channel modulator
isonicotinamide	Nicotinamide derivative
licochalcone-a	Topoisomerase inhibitor
lithium-chloride	Antiviral
M-344	HDAC inhibitor
MC-1293	HDAC inhibitor
NO-ASA	Cyclooxygenase inhibitor
oxamflatin	HDAC inhibitor
PMSF	Serine protease inhibitor
plumbagin	Apoptosis stimulant
purpurogallin	Catechol O methyltransferase inhibitor
STF-62247	Autophagy inducer
spermidine	Glutamate receptor modulator
suberoyl-bis-hydroxamic-acid	HDAC inhibitor
TNP-470	Methionine aminopeptidase inhibitor
timosaponin	MTOR inhibitor
trehalose	Pharmacological chaperone
triacetylresveratrol	TP53 activator
usnic-acid	Bacterial DNA inhibitor
valproxam	HDAC inhibitor
WAY-262611	WNT agonist
z-guggulsterone	FXR antagonist|Progesterone receptor agonist
Z-36	BCL inhibitor
SA-97110	Caspase inhibitor
AZD-1152HQPA	Aurora kinase inhibitor
l-buthionine-sulfoximine	Gamma-glutamylcysteine synthetase inhibitor
cisplatin	DNA alkylating agent|DNA synthesis inhibitor
iniparib	PARP inhibitor
alpha-tocopherol	Antioxidant
BRD-K93367411	Kelch-like ECH-associated protein ligand
BRD-K98948170	Kelch-like ECH-associated protein ligand
COL-3	Matrix metalloprotease inhibitor
MW-SHH-151	Hedgehog pathway modulator
MW-SHH-250	Hedgehog pathway modulator
MW-SHH-97	Smoothened receptor antagonist
MW-SHH-98	Hedgehog pathway modulator
MW-SHH-28	Hedgehog pathway modulator
avicin-d	NFkB pathway inhibitor
avicin-g	NFkB pathway inhibitor
tert-butylhydroquinone	ATPase inhibitor|MAP kinase inhibitor
tigecycline	Bacterial 30S ribosomal subunit inhibitor
dabrafenib	RAF inhibitor
MRE-269	Platelet aggregation inhibitor|Prostanoid receptor agonist
avrainvillamide-analog-3	Nucleophosmin inhibitor
avrainvillamide-analog-5	Nucleophosmin inhibitor
ENMD-2076	Aurora kinase inhibitor|FLT3 inhibitor|VEGFR inhibitor
equol	Estrogen receptor agonist
avrainvillamide-analog-2	Nucleophosmin inhibitor
avrainvillamide-analog-1	Nucleophosmin inhibitor
avrainvillamide-analog-4	Nucleophosmin inhibitor
avrainvillamide-analog-6	Nucleophosmin inhibitor
PF-543	Sphingosine kinase inhibitor
AT-9283	Aurora kinase inhibitor|JAK inhibitor|Abl kinase inhibitor|Bcr-Abl kinase inhibitor|FLT3 inhibitor|Mitotic inhibitor|Protein kinase inhibitor
MK-5108	Aurora kinase inhibitor
alisertib	Aurora kinase inhibitor
AVA	Nucleophosmin inhibitor
